TCTCTCCATCG	ASCIIString["CTCTCCATCGC"]
TTACGAATACG	ASCIIString["TACGAATACGT"]
GAAATAATATG	ASCIIString["AAATAATATGA"]
CCTAGTCCTAT	ASCIIString["CTAGTCCTATG"]
GCGAACAATTG	ASCIIString["CGAACAATTGT"]
CGAGGAGTTCA	ASCIIString["GAGGAGTTCAG"]
GAGGTGTATGC	ASCIIString["AGGTGTATGCA"]
AGCTGGATCAT	ASCIIString["GCTGGATCATG"]
GGAGGTCGGAG	ASCIIString["GAGGTCGGAGA"]
AATCTGGAAGG	ASCIIString["ATCTGGAAGGC"]
TGGATCTTCCT	ASCIIString["GGATCTTCCTT"]
CCTGTTAACCT	ASCIIString["CTGTTAACCTG"]
GCAGCGGTGGA	ASCIIString["CAGCGGTGGAT"]
TGCGGTCGCAC	ASCIIString["GCGGTCGCACA"]
TGACGCGAACA	ASCIIString["GACGCGAACAA"]
ATAATTGTCAA	ASCIIString["TAATTGTCAAG"]
GAAAACAAAAC	ASCIIString["AAAACAAAACA"]
ACCCAGTCTGA	ASCIIString["CCCAGTCTGAG"]
TAGCCCCAGGT	ASCIIString["AGCCCCAGGTC"]
CATCCTTTGAA	ASCIIString["ATCCTTTGAAG"]
TGTTAACCTGC	ASCIIString["GTTAACCTGCG"]
GGTTGTAGGCA	ASCIIString["GTTGTAGGCAA"]
ATAATGAGAGG	ASCIIString["TAATGAGAGGC"]
GTGCGTGAGGT	ASCIIString["TGCGTGAGGTC"]
CGGGGCAACAA	ASCIIString["GGGGCAACAAG"]
TGTCAAGAAAT	ASCIIString["GTCAAGAAATA"]
GTGGATACAGC	ASCIIString["TGGATACAGCT"]
ATGAGAGGCGC	ASCIIString["TGAGAGGCGCC"]
TGAGAGAACCG	ASCIIString["GAGAGAACCGT"]
CGGAGTCGGCC	ASCIIString["GGAGTCGGCCA"]
CCTCCCTCCAG	ASCIIString["CTCCCTCCAGT"]
CAGGCACGATA	ASCIIString["AGGCACGATAG"]
TAAGTATTGAG	ASCIIString["AAGTATTGAGG"]
CTCCCTCCAGT	ASCIIString["TCCCTCCAGTT"]
CGGAGATGTAG	ASCIIString["GGAGATGTAGC"]
ATTAAGAGCGT	ASCIIString["TTAAGAGCGTC"]
CATAAGTATTG	ASCIIString["ATAAGTATTGA"]
AGGTGGCGTAC	ASCIIString["GGTGGCGTACG"]
CTAAGTTGCGG	ASCIIString["TAAGTTGCGGG"]
GACGTCCATCC	ASCIIString["ACGTCCATCCT"]
CCTTCTATGAT	ASCIIString["CTTCTATGATT"]
CCACGTGGAAA	ASCIIString["CACGTGGAAAG"]
GCAGCAGCGGT	ASCIIString["CAGCAGCGGTG"]
TTTAACCACTA	ASCIIString["TTAACCACTAA"]
CATACGTGCTT	ASCIIString["ATACGTGCTTA"]
TATAGAATTAT	ASCIIString["ATAGAATTATC"]
GTCGAGAGAAA	ASCIIString["TCGAGAGAAAA"]
GGAGGATGTAG	ASCIIString["GAGGATGTAGC"]
AGTCGGCCATA	ASCIIString["GTCGGCCATAC"]
TGTCCCGGTAC	ASCIIString["GTCCCGGTACC"]
CGAATACGTAT	ASCIIString["GAATACGTATG"]
GGATGGCAATT	ASCIIString["GATGGCAATTA"]
GCACACATAAG	ASCIIString["CACACATAAGT"]
CGAGAGTTGCA	ASCIIString["GAGAGTTGCAA"]
CTAAGCTGGCG	ASCIIString["TAAGCTGGCGA"]
AACTTAGTAGG	ASCIIString["ACTTAGTAGGC"]
GGCTGCCATAG	ASCIIString["GCTGCCATAGT"]
GAATACTATAT	ASCIIString["AATACTATATG"]
GAGCCAGATAG	ASCIIString["AGCCAGATAGA"]
GCTGCCATAGT	ASCIIString["CTGCCATAGTA"]
TAATCGATTGG	ASCIIString["AATCGATTGGA"]
TGAAGTAGCTA	ASCIIString["GAAGTAGCTAG"]
AGCCTAGTCCT	ASCIIString["GCCTAGTCCTA"]
TCAATGAGCGG	ASCIIString["CAATGAGCGGT"]
CGATTGAGTCC	ASCIIString["GATTGAGTCCC"]
TTTCGAAAGGC	ASCIIString["TTCGAAAGGCA"]
TCAAACATTAC	ASCIIString["CAAACATTACG"]
GCTACGACTCA	ASCIIString["CTACGACTCAT"]
CTTTCAACCGC	ASCIIString["TTTCAACCGCT"]
GCGCCAAGGGA	ASCIIString["CGCCAAGGGAG"]
TAAATCTGGAA	ASCIIString["AAATCTGGAAG"]
GGGCCCGCACC	ASCIIString["GGCCCGCACCT"]
ATCAGCCTAGT	ASCIIString["TCAGCCTAGTC"]
GCGAGAGTTGC	ASCIIString["CGAGAGTTGCA"]
AACCACTAAGT	ASCIIString["ACCACTAAGTT"]
GTGCATAGAAG	ASCIIString["TGCATAGAAGA"]
GTAATCGGGGC	ASCIIString["TAATCGGGGCA"]
TGGCGAGCCCC	ASCIIString["GGCGAGCCCCA"]
TAGTCCTATGT	ASCIIString["AGTCCTATGTT"]
TGCAAGTGTTC	ASCIIString["GCAAGTGTTCA"]
CAATTAGTTAG	ASCIIString["AATTAGTTAGC"]
AGGAGGATGTA	ASCIIString["GGAGGATGTAG"]
GAAGGGGTGTT	ASCIIString["AAGGGGTGTTG"]
GTACCAAGCGT	ASCIIString["TACCAAGCGTT"]
CTGCAAAAACT	ASCIIString["TGCAAAAACTT"]
AGCCCCAGGTC	ASCIIString["GCCCCAGGTCA"]
AGGCCTATTAC	ASCIIString["GGCCTATTACG"]
GCGAGCCATCA	ASCIIString["CGAGCCATCAG"]
CTCATAGCTAT	ASCIIString["TCATAGCTATT"]
GCGATTTCTTA	ASCIIString["CGATTTCTTAT"]
AAGCGTTTAAT	ASCIIString["AGCGTTTAATA"]
GTCTCAGCCAG	ASCIIString["TCTCAGCCAGA"]
GCTGGCGAGCC	ASCIIString["CTGGCGAGCCC"]
GAAAGGCAGAA	ASCIIString["AAAGGCAGAAC"]
CCTCTGTCTGT	ASCIIString["CTCTGTCTGTT"]
CGCACCTTCGA	ASCIIString["GCACCTTCGAT"]
TCTCCATCGCA	ASCIIString["CTCCATCGCAA"]
ATGGATGGCAA	ASCIIString["TGGATGGCAAT"]
CCCATGTCAAG	ASCIIString["CCATGTCAAGA"]
TTAGCCAACTT	ASCIIString["TAGCCAACTTT"]
CCGGCACACAT	ASCIIString["CGGCACACATA"]
ATCAGTGTTTG	ASCIIString["TCAGTGTTTGA"]
GTGTACGGAAT	ASCIIString["TGTACGGAATA","TGTACGGAATA"]
TCAGTGTTTGA	ASCIIString["CAGTGTTTGAG"]
TTCCATATCAA	ASCIIString["TCCATATCAAG"]
ACTATATGGAT	ASCIIString["CTATATGGATG"]
CCTGCGGTAGC	ASCIIString["CTGCGGTAGCG"]
CGATCAGGGTA	ASCIIString["GATCAGGGTAC"]
CTTATAATTGT	ASCIIString["TTATAATTGTC"]
ATATATAACCG	ASCIIString["TATATAACCGC"]
TTATCCTCTTG	ASCIIString["TATCCTCTTGT"]
AGACGATCTAA	ASCIIString["GACGATCTAAA"]
GTTCCTTCACA	ASCIIString["TTCCTTCACAG"]
ACCCACATCTC	ASCIIString["CCCACATCTCA"]
ATCGGCATAAT	ASCIIString["TCGGCATAATG"]
CTGTGTGGCGA	ASCIIString["TGTGTGGCGAG"]
TGACGGCCGAA	ASCIIString["GACGGCCGAAG"]
GGAATACTATA	ASCIIString["GAATACTATAT"]
CGATTACCCAA	ASCIIString["GATTACCCAAG"]
TTTACTGGGTG	ASCIIString["TTACTGGGTGC"]
TATCCGGCTCA	ASCIIString["ATCCGGCTCAA"]
GTTCTATCACA	ASCIIString["TTCTATCACAG"]
CAGTTAACTCG	ASCIIString["AGTTAACTCGT"]
AGCAGGGACCC	ASCIIString["GCAGGGACCCA"]
GGAATAGGGAG	ASCIIString["GAATAGGGAGG"]
ATAACCCACGA	ASCIIString["TAACCCACGAC"]
AGTGAAACTTA	ASCIIString["GTGAAACTTAG"]
GTCTACACGTG	ASCIIString["TCTACACGTGT"]
GCCATTCCCTT	ASCIIString["CCATTCCCTTT"]
ACGTGTCTCAG	ASCIIString["CGTGTCTCAGC"]
CAGTACCTAAC	ASCIIString["AGTACCTAACG"]
CTATGATTTGA	ASCIIString["TATGATTTGAG"]
GGTACGAAGGC	ASCIIString["GTACGAAGGCT"]
GCGAGGAGTTC	ASCIIString["CGAGGAGTTCA"]
GTGCGGGCAGG	ASCIIString["TGCGGGCAGGG"]
ACTTCATGTTA	ASCIIString["CTTCATGTTAT"]
GGAGGAGGTCG	ASCIIString["GAGGAGGTCGG"]
GGAGATGTAGC	ASCIIString["GAGATGTAGCA"]
AAGCTATCCGG	ASCIIString["AGCTATCCGGC"]
GCGGAGATGTA	ASCIIString["CGGAGATGTAG"]
GGTGCGTGAGG	ASCIIString["GTGCGTGAGGT"]
CGGAGATCCCA	ASCIIString["GGAGATCCCAC"]
TATCAAGATTT	ASCIIString["ATCAAGATTTA"]
GGAGATCCCAC	ASCIIString["GAGATCCCACA"]
GGTGAGCGAGG	ASCIIString["GTGAGCGAGGA"]
AGGGGTGTTGG	ASCIIString["GGGGTGTTGGT"]
TCCTGTGCATA	ASCIIString["CCTGTGCATAG"]
ATCTAAACAGG	ASCIIString["TCTAAACAGGC"]
ATGCTTTCGTA	ASCIIString["TGCTTTCGTAA"]
AGTAGGTTTCT	ASCIIString["GTAGGTTTCTA"]
AGGCAGAACAA	ASCIIString["GGCAGAACAAC"]
ACCTCTTTGTG	ASCIIString["CCTCTTTGTGC"]
CCCCATTCTTG	ASCIIString["CCCATTCTTGG"]
GGATACAGTTG	ASCIIString["GATACAGTTGG"]
CGCTGGCAGCT	ASCIIString["GCTGGCAGCTT"]
GCCCGCGCGAG	ASCIIString["CCCGCGCGAGA"]
GTTGCTGCGGA	ASCIIString["TTGCTGCGGAC"]
ATTGAGTCCCC	ASCIIString["TTGAGTCCCCA"]
TTCAAAACAAA	ASCIIString["TCAAAACAAAT"]
TGCTGTGTACG	ASCIIString["GCTGTGTACGG"]
GGCACACATAA	ASCIIString["GCACACATAAG"]
TTGCATGCCAT	ASCIIString["TGCATGCCATT"]
GTAGTAGAGGG	ASCIIString["TAGTAGAGGGG"]
GATAGCCCCAG	ASCIIString["ATAGCCCCAGG"]
CGGCCGAAGAC	ASCIIString["GGCCGAAGACG"]
TGGTAGCGATC	ASCIIString["GGTAGCGATCA"]
TTGGAGGTTCT	ASCIIString["TGGAGGTTCTA"]
TACGACTCATT	ASCIIString["ACGACTCATTG"]
GAACAACAAGC	ASCIIString["AACAACAAGCA"]
TCGTTGAACCA	ASCIIString["CGTTGAACCAG"]
GGATGTTCATC	ASCIIString["GATGTTCATCC"]
AGAGAACCGTT	ASCIIString["GAGAACCGTTC"]
GGAGGTTCTAT	ASCIIString["GAGGTTCTATC"]
CAGAACAGTGC	ASCIIString["AGAACAGTGCG"]
ACAGTTGGTAG	ASCIIString["CAGTTGGTAGC"]
CCCCCCCCTAG	ASCIIString["CCCCCCCTAGA"]
ATGTACTGTGG	ASCIIString["TGTACTGTGGG"]
TATCACAGTTA	ASCIIString["ATCACAGTTAA"]
GGTGACGGCCG	ASCIIString["GTGACGGCCGA"]
CAGCTGGATCA	ASCIIString["AGCTGGATCAT"]
TCCATAGGTGG	ASCIIString["CCATAGGTGGA"]
TATAGAGCCAC	ASCIIString["ATAGAGCCACT"]
CACACATAAGT	ASCIIString["ACACATAAGTA"]
TTGAGAGAGGT	ASCIIString["TGAGAGAGGTT"]
CTCTCCATCGC	ASCIIString["TCTCCATCGCA"]
GAAGACGTACG	ASCIIString["AAGACGTACGG"]
CCTCGATAACT	ASCIIString["CTCGATAACTG"]
GCGTCGAGAGA	ASCIIString["CGTCGAGAGAA"]
AGGCTAAGCTG	ASCIIString["GGCTAAGCTGG"]
GCGTAACTACC	ASCIIString["CGTAACTACCA"]
TATAATTGTCA	ASCIIString["ATAATTGTCAA"]
AGGGATACAGT	ASCIIString["GGGATACAGTT"]
CCCCATCTGGG	ASCIIString["CCCATCTGGGT"]
AGGAGTGTGCT	ASCIIString["GGAGTGTGCTT"]
CTCTAATTCGT	ASCIIString["TCTAATTCGTG"]
CTAGACATGTC	ASCIIString["TAGACATGTCA"]
CCATCTGGATC	ASCIIString["CATCTGGATCT"]
GGTGGATACAG	ASCIIString["GTGGATACAGC"]
AATCCAGCAGC	ASCIIString["ATCCAGCAGCA"]
TGTACCAAGCG	ASCIIString["GTACCAAGCGT"]
GCGCGAGAGTT	ASCIIString["CGCGAGAGTTG"]
TCTGAGCTATA	ASCIIString["CTGAGCTATAA"]
GCCCTCCCAAC	ASCIIString["CCCTCCCAACT"]
TAAGACGATCT	ASCIIString["AAGACGATCTA"]
TGCATGCCATT	ASCIIString["GCATGCCATTC"]
TACAGTTGGTA	ASCIIString["ACAGTTGGTAG"]
GAAACACCTAC	ASCIIString["AAACACCTACT"]
GAGGGGGTCGG	ASCIIString["AGGGGGTCGGA"]
CAGTTGGTAGC	ASCIIString["AGTTGGTAGCG"]
TTCTGCGGACC	ASCIIString["TCTGCGGACCT"]
AGTTGTTTGCA	ASCIIString["GTTGTTTGCAT"]
ACAGTTCCTTC	ASCIIString["CAGTTCCTTCA"]
ACCGCTGGCAG	ASCIIString["CCGCTGGCAGC"]
GGTTTATAAAT	ASCIIString["GTTTATAAATC"]
TCTGTCTGTTT	ASCIIString["CTGTCTGTTTT"]
ATGTCAGGTCA	ASCIIString["TGTCAGGTCAT"]
GATGATATGTC	ASCIIString["ATGATATGTCA"]
GTTGGTCTCAA	ASCIIString["TTGGTCTCAAT"]
GAGGTCGGAGA	ASCIIString["AGGTCGGAGAT"]
GAGTTCAGCAG	ASCIIString["AGTTCAGCAGC"]
TTTGCCTTCTA	ASCIIString["TTGCCTTCTAT"]
AACTCGTGTCC	ASCIIString["ACTCGTGTCCA"]
AAAGTTGTTCC	ASCIIString["AAGTTGTTCCA"]
CTGTGGGTGCT	ASCIIString["TGTGGGTGCTG"]
GATGTGCGGTC	ASCIIString["ATGTGCGGTCG"]
TGGTGTACGGA	ASCIIString["GGTGTACGGAA"]
GCGTGGCGGTT	ASCIIString["CGTGGCGGTTT"]
CCCACGACCGC	ASCIIString["CCACGACCGCG"]
CAACTTTCATG	ASCIIString["AACTTTCATGC"]
GACGCGAACAA	ASCIIString["ACGCGAACAAT"]
TTATAAGAGGG	ASCIIString["TATAAGAGGGA"]
AGTAGAGGGGG	ASCIIString["GTAGAGGGGGT"]
GATTTCTTATC	ASCIIString["ATTTCTTATCA"]
TAGAAGAATGC	ASCIIString["AGAAGAATGCT"]
ACGTGGAAAGT	ASCIIString["CGTGGAAAGTT"]
ACGATTGAGTC	ASCIIString["CGATTGAGTCC"]
AACAAAACAGT	ASCIIString["ACAAAACAGTG"]
ATCCGGCTCAA	ASCIIString["TCCGGCTCAAA"]
AGCTATCCGGC	ASCIIString["GCTATCCGGCT"]
AGAGCCACTGC	ASCIIString["GAGCCACTGCA"]
CATGAAAAGAG	ASCIIString["ATGAAAAGAGG"]
CTTCACAGGTC	ASCIIString["TTCACAGGTCA"]
CACGTTGCCTG	ASCIIString["ACGTTGCCTGG"]
TTCAGCAGCTG	ASCIIString["TCAGCAGCTGG"]
GGGGAAAAAGG	ASCIIString["GGGAAAAAGGG"]
AGCAACACAGA	ASCIIString["GCAACACAGAA"]
GTGACGGCCGA	ASCIIString["TGACGGCCGAA"]
GCAAACCTACC	ASCIIString["CAAACCTACCT"]
TACGAAGGCTA	ASCIIString["ACGAAGGCTAA"]
CACGGCTACGA	ASCIIString["ACGGCTACGAC"]
TTGAGGTGTAT	ASCIIString["TGAGGTGTATG"]
GCAGCATCACC	ASCIIString["CAGCATCACCA"]
GACATGTCAGG	ASCIIString["ACATGTCAGGT"]
GTACCTAACGG	ASCIIString["TACCTAACGGG"]
GTTGCGGGTAA	ASCIIString["TTGCGGGTAAT"]
GGTGTACGGAA	ASCIIString["GTGTACGGAAT"]
TGCAGCTCTAA	ASCIIString["GCAGCTCTAAT"]
AATGCTTTCGT	ASCIIString["ATGCTTTCGTA"]
TCCTTTCAACC	ASCIIString["CCTTTCAACCG"]
AACTGAGAGAA	ASCIIString["ACTGAGAGAAC"]
TGAACCAGTGG	ASCIIString["GAACCAGTGGA"]
ACGACTTGCGG	ASCIIString["CGACTTGCGGC"]
TGAGGTGGCGT	ASCIIString["GAGGTGGCGTA"]
CACATCTCAAA	ASCIIString["ACATCTCAAAT"]
TACTACCCGTA	ASCIIString["ACTACCCGTAT"]
AGCATCACCAA	ASCIIString["GCATCACCAAA"]
ACAAGCAGCAT	ASCIIString["CAAGCAGCATC"]
TATCAGTGTTT	ASCIIString["ATCAGTGTTTG"]
CTCCCAACTTC	ASCIIString["TCCCAACTTCA"]
AGTCTGAGCTA	ASCIIString["GTCTGAGCTAT"]
ATTGGAACCTC	ASCIIString["TTGGAACCTCC"]
AGGCAACGGAG	ASCIIString["GGCAACGGAGC"]
CGCAGCACGCA	ASCIIString["GCAGCACGCAG"]
TCATGGTGACG	ASCIIString["CATGGTGACGG"]
AGTGACGCGAA	ASCIIString["GTGACGCGAAC"]
CGGCCATACGT	ASCIIString["GGCCATACGTG"]
TCCAGTTAGCC	ASCIIString["CCAGTTAGCCA"]
TTTGAGGTGTA	ASCIIString["TTGAGGTGTAT"]
ACACGTTGCCT	ASCIIString["CACGTTGCCTG"]
GTCACGTGTCC	ASCIIString["TCACGTGTCCG"]
GCGTGGTTGTA	ASCIIString["CGTGGTTGTAG"]
GGCCCGCACCT	ASCIIString["GCCCGCACCTT"]
ACCCGTATCGT	ASCIIString["CCCGTATCGTT"]
GTTAGCCAACT	ASCIIString["TTAGCCAACTT"]
GTATACGGCCT	ASCIIString["TATACGGCCTT"]
TGCGCAGGTGC	ASCIIString["GCGCAGGTGCC"]
AACCCACGACC	ASCIIString["ACCCACGACCG"]
ACCGCGTACCC	ASCIIString["CCGCGTACCCA"]
AACTTTTCTCT	ASCIIString["ACTTTTCTCTC"]
TGTTCATGTAT	ASCIIString["GTTCATGTATA"]
GCTATCCGGCT	ASCIIString["CTATCCGGCTC"]
TCGGCATAATG	ASCIIString["CGGCATAATGA"]
TAGCTAGTGCG	ASCIIString["AGCTAGTGCGA"]
CTCGATAACTG	ASCIIString["TCGATAACTGG"]
CTGTTTTCGAA	ASCIIString["TGTTTTCGAAA"]
AGGTCCCATGT	ASCIIString["GGTCCCATGTC"]
CTATAATCGTT	ASCIIString["TATAATCGTTC"]
AGCCAGATCGG	ASCIIString["GCCAGATCGGC"]
TTTCAACCGCT	ASCIIString["TTCAACCGCTT"]
CTTCATGTTAT	ASCIIString["TTCATGTTATA"]
ATAGAAGAATG	ASCIIString["TAGAAGAATGC"]
AATTGTCCCGG	ASCIIString["ATTGTCCCGGT"]
TTGGTCTCAAT	ASCIIString["TGGTCTCAATG"]
TAGTACAACAC	ASCIIString["AGTACAACACT"]
TGCGGGCAGGG	ASCIIString["GCGGGCAGGGG"]
ACGATGATATG	ASCIIString["CGATGATATGT"]
GGAGTGTGCTT	ASCIIString["GAGTGTGCTTC"]
CACAGTTAACT	ASCIIString["ACAGTTAACTC"]
ACCGTTAAAAC	ASCIIString["CCGTTAAAACT"]
TCCCTCCAGTT	ASCIIString["CCCTCCAGTTA"]
GGAGTCGGCCA	ASCIIString["GAGTCGGCCAT"]
CCTGTGCATAG	ASCIIString["CTGTGCATAGA"]
CTGGATCTTCC	ASCIIString["TGGATCTTCCT"]
GTATTGAGGTG	ASCIIString["TATTGAGGTGG"]
GGGTATAGAAT	ASCIIString["GGTATAGAATT"]
GCACCTTCGAT	ASCIIString["CACCTTCGATT"]
TACTCCTGTGC	ASCIIString["ACTCCTGTGCA"]
AGCTCTAATTC	ASCIIString["GCTCTAATTCG"]
TGTGGCGAGCC	ASCIIString["GTGGCGAGCCA"]
CGTGCCTGTTA	ASCIIString["GTGCCTGTTAA"]
ATCAGTGAAAC	ASCIIString["TCAGTGAAACT"]
AGCCAGAAGCT	ASCIIString["GCCAGAAGCTA"]
CAGTCAGTGGA	ASCIIString["AGTCAGTGGAG"]
AGGCGATACAT	ASCIIString["GGCGATACATG"]
GATCCACGTGG	ASCIIString["ATCCACGTGGA"]
AGCAGCGGTGG	ASCIIString["GCAGCGGTGGA"]
GAGAAAAGAGA	ASCIIString["AGAAAAGAGAT"]
ACGGCCGAAGA	ASCIIString["CGGCCGAAGAC"]
TCTGGAAGGCC	ASCIIString["CTGGAAGGCCT"]
CCATCGCAATA	ASCIIString["CATCGCAATAA"]
CAGGTGAGCGA	ASCIIString["AGGTGAGCGAG"]
AACAAGGTACG	ASCIIString["ACAAGGTACGA"]
CGACTTGCGGC	ASCIIString["GACTTGCGGCG"]
AAAGGCAGAAC	ASCIIString["AAGGCAGAACA"]
ACGTTGCCTGG	ASCIIString["CGTTGCCTGGT"]
AGCCACTGCAA	ASCIIString["GCCACTGCAAA"]
TATCGTTAAGG	ASCIIString["ATCGTTAAGGA"]
TTAGGAGGATG	ASCIIString["TAGGAGGATGT"]
AGCCACGGCTG	ASCIIString["GCCACGGCTGC"]
CCTATGTTTCC	ASCIIString["CTATGTTTCCA"]
ATGATGGTCTA	ASCIIString["TGATGGTCTAC"]
GTCGGACCTAT	ASCIIString["TCGGACCTATT"]
TTCCTTCACAG	ASCIIString["TCCTTCACAGG"]
TGGTTGTAGGC	ASCIIString["GGTTGTAGGCA"]
TTATCAGTCAG	ASCIIString["TATCAGTCAGT"]
TAAGTTGCGGG	ASCIIString["AAGTTGCGGGT"]
GAACCGTTCCT	ASCIIString["AACCGTTCCTC"]
CGAGGCGATAC	ASCIIString["GAGGCGATACA"]
CAGGAATAGGG	ASCIIString["AGGAATAGGGA"]
ACATAATGGAA	ASCIIString["CATAATGGAAC"]
TCGGAGATCCC	ASCIIString["CGGAGATCCCA"]
ATCCCCCCCCT	ASCIIString["TCCCCCCCCTA"]
CCATCCTTTGA	ASCIIString["CATCCTTTGAA"]
GCTCCTTTCAA	ASCIIString["CTCCTTTCAAC"]
GCAACAAGGTA	ASCIIString["CAACAAGGTAC"]
ATTGTCAAGCC	ASCIIString["TTGTCAAGCCA"]
GAGTCCCCATC	ASCIIString["AGTCCCCATCT"]
TAACTGGTGTA	ASCIIString["AACTGGTGTAC"]
CCACTAAGTTG	ASCIIString["CACTAAGTTGC"]
GCAGTACGATT	ASCIIString["CAGTACGATTG"]
AAGTATTGAGG	ASCIIString["AGTATTGAGGT"]
ACGACTCATTG	ASCIIString["CGACTCATTGG"]
TCATGTATACG	ASCIIString["CATGTATACGG"]
ATTTCTTATCA	ASCIIString["TTTCTTATCAG"]
CGGTGACCAAA	ASCIIString["GGTGACCAAAT"]
TAGCAACACAG	ASCIIString["AGCAACACAGA"]
TTGGAACCTCC	ASCIIString["TGGAACCTCCC"]
GGGGGAGAGGC	ASCIIString["GGGGAGAGGCC"]
GAAAAGAGGAT	ASCIIString["AAAAGAGGATA"]
CCTCCCCTCAT	ASCIIString["CTCCCCTCATA"]
TCGATTACCCA	ASCIIString["CGATTACCCAA"]
ATAGAGCCACT	ASCIIString["TAGAGCCACTG"]
TCTGCACGCAG	ASCIIString["CTGCACGCAGC"]
GTTCATCCCCC	ASCIIString["TTCATCCCCCC"]
GGTGTATGCAG	ASCIIString["GTGTATGCAGC"]
TCACAGGTCAC	ASCIIString["CACAGGTCACG"]
AGCACGACTTG	ASCIIString["GCACGACTTGC"]
TCAGCCTAGTC	ASCIIString["CAGCCTAGTCC"]
TGCCTGGTAGC	ASCIIString["GCCTGGTAGCG"]
CGTAAGACGAT	ASCIIString["GTAAGACGATC"]
AATACGTATGG	ASCIIString["ATACGTATGGT"]
AATGCGCAGGT	ASCIIString["ATGCGCAGGTG"]
CCAAATAACCC	ASCIIString["CAAATAACCCA"]
CGATAGCCCCA	ASCIIString["GATAGCCCCAG"]
ATACGTATGGT	ASCIIString["TACGTATGGTC"]
GATTGGAGGTT	ASCIIString["ATTGGAGGTTC"]
ATAACTGAGAG	ASCIIString["TAACTGAGAGA"]
CGAAACACCTA	ASCIIString["GAAACACCTAC"]
CTATGTTTCCA	ASCIIString["TATGTTTCCAT"]
ATATAGAGCCA	ASCIIString["TATAGAGCCAC"]
CCCGTATCGTT	ASCIIString["CCGTATCGTTA"]
TTGGTCACACG	ASCIIString["TGGTCACACGT"]
CGGACCTGGAC	ASCIIString["GGACCTGGACT"]
ATATGTCACGT	ASCIIString["TATGTCACGTG"]
TCCGGCTCAAA	ASCIIString["CCGGCTCAAAC"]
AACAGGCACGA	ASCIIString["ACAGGCACGAT"]
CCAGTGGATGA	ASCIIString["CAGTGGATGAA"]
AGGCAAACCTA	ASCIIString["GGCAAACCTAC"]
TTCTTTGCCTT	ASCIIString["TCTTTGCCTTC"]
TTTGCATGCCA	ASCIIString["TTGCATGCCAT"]
CGACGAGGCGA	ASCIIString["GACGAGGCGAT"]
AGCTAGTGAAT	ASCIIString["GCTAGTGAATC"]
AGCGATTTCTT	ASCIIString["GCGATTTCTTA"]
GACGATCTAAA	ASCIIString["ACGATCTAAAC"]
TAGCGTGGTTG	ASCIIString["AGCGTGGTTGT"]
CAACAAGGTAC	ASCIIString["AACAAGGTACG"]
GATACAGTTGG	ASCIIString["ATACAGTTGGT"]
CACGCAGCACG	ASCIIString["ACGCAGCACGC"]
TCACGTGTCCG	ASCIIString["CACGTGTCCGG"]
ACCTTCGATTA	ASCIIString["CCTTCGATTAC"]
CAGCAGCAGCG	ASCIIString["AGCAGCAGCGG"]
AAACAGGCACG	ASCIIString["AACAGGCACGA"]
GGCTCAAACAT	ASCIIString["GCTCAAACATT"]
CGCACATAATG	ASCIIString["GCACATAATGG"]
GCTTATAATTG	ASCIIString["CTTATAATTGT"]
CGGAATATCAG	ASCIIString["GGAATATCAGC"]
GGTCCTCCTCT	ASCIIString["GTCCTCCTCTG"]
TAGTGAATCGA	ASCIIString["AGTGAATCGAA"]
TGGACTAAGCC	ASCIIString["GGACTAAGCCA"]
CGGACCCGGCA	ASCIIString["GGACCCGGCAC"]
GCGAAAGGTCA	ASCIIString["CGAAAGGTCAG"]
AGAGGGAGGAG	ASCIIString["GAGGGAGGAGG"]
ATGTTATAAGA	ASCIIString["TGTTATAAGAG"]
GGTCACACGTT	ASCIIString["GTCACACGTTG"]
CTTATGCCTAG	ASCIIString["TTATGCCTAGG"]
AGCCAACTTTC	ASCIIString["GCCAACTTTCA"]
CGTGGCGGTTT	ASCIIString["GTGGCGGTTTA"]
AGAAAAGAGAT	ASCIIString["GAAAAGAGATC"]
TTAAGAGCGTC	ASCIIString["TAAGAGCGTCG"]
TTGCTGCGGAC	ASCIIString["TGCTGCGGACC"]
CGTACGGTGAC	ASCIIString["GTACGGTGACC"]
AGGTACGAAGG	ASCIIString["GGTACGAAGGC"]
TAGGTTTCTAG	ASCIIString["AGGTTTCTAGG"]
GTTATAAGAGG	ASCIIString["TTATAAGAGGG"]
CCCATTCTTGG	ASCIIString["CCATTCTTGGT"]
CCTGGTAGCGA	ASCIIString["CTGGTAGCGAT"]
AGGGGGTCGGA	ASCIIString["GGGGGTCGGAG"]
GACCCAGTCTG	ASCIIString["ACCCAGTCTGA"]
TGAGGTGTATG	ASCIIString["GAGGTGTATGC"]
TAAGAGGGAGG	ASCIIString["AAGAGGGAGGA"]
GCCTGTTAACC	ASCIIString["CCTGTTAACCT"]
AGGCAAGAGTC	ASCIIString["GGCAAGAGTCT"]
GGGTACTCCTG	ASCIIString["GGTACTCCTGT"]
GGTCAGGTGAG	ASCIIString["GTCAGGTGAGC"]
ACTGCAAAAAC	ASCIIString["CTGCAAAAACT"]
TAACGGGGCCC	ASCIIString["AACGGGGCCCT"]
GCAGGGACCCA	ASCIIString["CAGGGACCCAG"]
TTCGTAAGACG	ASCIIString["TCGTAAGACGA"]
GAATTATCCTC	ASCIIString["AATTATCCTCT"]
AGGTGAGCGAG	ASCIIString["GGTGAGCGAGG"]
TAGCGATTTCT	ASCIIString["AGCGATTTCTT"]
CTCCTGTGCAT	ASCIIString["TCCTGTGCATA"]
GGGCAGGGGAA	ASCIIString["GGCAGGGGAAA"]
GAGATCCACGT	ASCIIString["AGATCCACGTG"]
GGGTAATCGGG	ASCIIString["GGTAATCGGGG"]
CTATCACAGTT	ASCIIString["TATCACAGTTA"]
CCTTCGATTAC	ASCIIString["CTTCGATTACC"]
TACCCACATCT	ASCIIString["ACCCACATCTC"]
GTCCCATGTCA	ASCIIString["TCCCATGTCAA"]
CTTGCGGCGGA	ASCIIString["TTGCGGCGGAG"]
TGTGCTTCCCG	ASCIIString["GTGCTTCCCGC"]
AAATTAAGAGC	ASCIIString["AATTAAGAGCG"]
ATATGATGTGC	ASCIIString["TATGATGTGCG"]
ACGAATACGTA	ASCIIString["CGAATACGTAT"]
ACGTCCATCCT	ASCIIString["CGTCCATCCTT"]
CACCGTTAAAA	ASCIIString["ACCGTTAAAAC"]
ATCGATTGGAG	ASCIIString["TCGATTGGAGG"]
TAAGAGCGTCG	ASCIIString["AAGAGCGTCGA"]
AGCCATCAGTG	ASCIIString["GCCATCAGTGA"]
GATACATGATG	ASCIIString["ATACATGATGG"]
AGCTATAACGA	ASCIIString["GCTATAACGAT"]
ACACCTACTTC	ASCIIString["CACCTACTTCA"]
GATACAGTACC	ASCIIString["ATACAGTACCT"]
CATTCCTCCCC	ASCIIString["ATTCCTCCCCT"]
AGTCTCCGTGC	ASCIIString["GTCTCCGTGCC"]
TTACCCAAGTT	ASCIIString["TACCCAAGTTG"]
TGGATCATGGT	ASCIIString["GGATCATGGTG"]
TGAGGTCCCAT	ASCIIString["GAGGTCCCATG"]
TCCCGGTACCT	ASCIIString["CCCGGTACCTC"]
CATTCTTGGTC	ASCIIString["ATTCTTGGTCA"]
CTTTCATGCTC	ASCIIString["TTTCATGCTCG"]
AAGGTACGAAG	ASCIIString["AGGTACGAAGG"]
ACAGTACCTAA	ASCIIString["CAGTACCTAAC"]
CAACCGCTTGG	ASCIIString["AACCGCTTGGG"]
AGTTGCAAGTG	ASCIIString["GTTGCAAGTGT"]
CCGGAGGGGCC	ASCIIString["CGGAGGGGCCC"]
ACGCATGAAAA	ASCIIString["CGCATGAAAAG"]
CAGTCTGAGCT	ASCIIString["AGTCTGAGCTA"]
ATAAATCCAGC	ASCIIString["TAAATCCAGCA"]
TCCCCTCATAG	ASCIIString["CCCCTCATAGC"]
CCTTCACAGGT	ASCIIString["CTTCACAGGTC"]
ACGGAATATCA	ASCIIString["CGGAATATCAG"]
TCAGCAGCTGG	ASCIIString["CAGCAGCTGGA"]
GACCTATTCGT	ASCIIString["ACCTATTCGTT"]
CTACCCGTATC	ASCIIString["TACCCGTATCG"]
GGTCTCAATGT	ASCIIString["GTCTCAATGTT"]
CGAAGACGTAC	ASCIIString["GAAGACGTACG"]
GTCCATAGGTG	ASCIIString["TCCATAGGTGG"]
GCATAAGGCGT	ASCIIString["CATAAGGCGTG"]
GGTGACCAAAT	ASCIIString["GTGACCAAATA"]
CCTTCAAAACA	ASCIIString["CTTCAAAACAA"]
GACTAAGCCAC	ASCIIString["ACTAAGCCACG"]
ATGATTTGAGG	ASCIIString["TGATTTGAGGT"]
TCAGCCAGAAG	ASCIIString["CAGCCAGAAGC"]
ACTTCACCGTT	ASCIIString["CTTCACCGTTA"]
GTTCATGTATA	ASCIIString["TTCATGTATAC"]
TGCCTTCTATG	ASCIIString["GCCTTCTATGA"]
CCGTATCGTTA	ASCIIString["CGTATCGTTAA"]
TACGGTGACCA	ASCIIString["ACGGTGACCAA"]
CCTAGACATGT	ASCIIString["CTAGACATGTC"]
AGGATGTAGCA	ASCIIString["GGATGTAGCAG"]
TAGCTATTAGG	ASCIIString["AGCTATTAGGA"]
ACGCTTATGCC	ASCIIString["CGCTTATGCCT"]
TTTCTAGGCCT	ASCIIString["TTCTAGGCCTA"]
AGACGTCCATC	ASCIIString["GACGTCCATCC"]
TACCAAGCGTT	ASCIIString["ACCAAGCGTTT"]
TCGGGGCAACA	ASCIIString["CGGGGCAACAA"]
ACCCGGCACAC	ASCIIString["CCCGGCACACA"]
ATAGCTATTAG	ASCIIString["TAGCTATTAGG"]
TGTTTTCGAAA	ASCIIString["GTTTTCGAAAG"]
TGGTCTACACG	ASCIIString["GGTCTACACGT"]
TCACGGCTACG	ASCIIString["CACGGCTACGA"]
CATATATAACC	ASCIIString["ATATATAACCG"]
GGTTCTATCAC	ASCIIString["GTTCTATCACA"]
CGTTAAAACTA	ASCIIString["GTTAAAACTAT"]
GTGCGAAAGGT	ASCIIString["TGCGAAAGGTC"]
GGAGAGGCCAT	ASCIIString["GAGAGGCCATC"]
TGGCAAGCTAT	ASCIIString["GGCAAGCTATC"]
GTAACTACCAC	ASCIIString["TAACTACCACT"]
CGTACCCACAT	ASCIIString["GTACCCACATC"]
CCCGCGCGAGA	ASCIIString["CCGCGCGAGAG"]
GGTATAGAATT	ASCIIString["GTATAGAATTA"]
TATACGGCCTT	ASCIIString["ATACGGCCTTC"]
ACGAAGGCTAA	ASCIIString["CGAAGGCTAAG"]
GTCCCGGTACC	ASCIIString["TCCCGGTACCT"]
CCGTTAAAACT	ASCIIString["CGTTAAAACTA"]
GTTGGTAGCGA	ASCIIString["TTGGTAGCGAT"]
AGCGGTAGTAG	ASCIIString["GCGGTAGTAGA"]
ACCACTAATCG	ASCIIString["CCACTAATCGA"]
CTTCGATTACC	ASCIIString["TTCGATTACCC"]
GGTACTCCTGT	ASCIIString["GTACTCCTGTG"]
CGTTTAATATA	ASCIIString["GTTTAATATAG"]
ACGATCTAAAC	ASCIIString["CGATCTAAACA"]
TGTCTCAGCCA	ASCIIString["GTCTCAGCCAG"]
AAACAAATTAA	ASCIIString["AACAAATTAAG"]
GTATAGAATTA	ASCIIString["TATAGAATTAT"]
TAGGGAGGAGT	ASCIIString["AGGGAGGAGTG"]
GGTCAGGAATA	ASCIIString["GTCAGGAATAG"]
TCCTACTACCC	ASCIIString["CCTACTACCCG"]
GTCAGGAATAG	ASCIIString["TCAGGAATAGG"]
AAACTTTTCTC	ASCIIString["AACTTTTCTCT"]
TAGGTGGAAGG	ASCIIString["AGGTGGAAGGG"]
ATGATATGTCA	ASCIIString["TGATATGTCAC"]
GCAAGTGTTCA	ASCIIString["CAAGTGTTCAT"]
CGTGTCCATAG	ASCIIString["GTGTCCATAGG"]
GAACAATTGTC	ASCIIString["AACAATTGTCC"]
ACTCCTGTGCA	ASCIIString["CTCCTGTGCAT"]
AAGGGGTGTTG	ASCIIString["AGGGGTGTTGG"]
GTGTGCTTCCC	ASCIIString["TGTGCTTCCCG"]
ACTTAGTAGGC	ASCIIString["CTTAGTAGGCA"]
TTCTCTGCATA	ASCIIString["TCTCTGCATAA"]
ATGAAAAGAGG	ASCIIString["TGAAAAGAGGA"]
AATAACTGAGA	ASCIIString["ATAACTGAGAG"]
CAGGTCATGTA	ASCIIString["AGGTCATGTAC"]
AGAGAGGTTAG	ASCIIString["GAGAGGTTAGC"]
AAGACGATCTA	ASCIIString["AGACGATCTAA"]
AAGAGGATACA	ASCIIString["AGAGGATACAG"]
AAGCTAGTGAA	ASCIIString["AGCTAGTGAAT"]
CTTAGTAGGCA	ASCIIString["TTAGTAGGCAA"]
ATGGAACGCTT	ASCIIString["TGGAACGCTTA"]
CGTGCTTATAA	ASCIIString["GTGCTTATAAT"]
GCACGACTTGC	ASCIIString["CACGACTTGCG"]
ACCAAACACCG	ASCIIString["CCAAACACCGA"]
CATCGCAATAA	ASCIIString["ATCGCAATAAC"]
TATCCTCTTGT	ASCIIString["ATCCTCTTGTA"]
CGCAGTTCTGC	ASCIIString["GCAGTTCTGCG"]
GTGAGCGAGGA	ASCIIString["TGAGCGAGGAG"]
ATCGCAATAAC	ASCIIString["TCGCAATAACT"]
TCTGCGGACCT	ASCIIString["CTGCGGACCTG"]
ATCATGGTGAC	ASCIIString["TCATGGTGACG"]
CCCCCTAGACA	ASCIIString["CCCCTAGACAT"]
GCTAAATCTGG	ASCIIString["CTAAATCTGGA"]
TATGGATGGCA	ASCIIString["ATGGATGGCAA"]
TATCAGCCTAG	ASCIIString["ATCAGCCTAGT"]
AGTACAACACT	ASCIIString["GTACAACACTA"]
ACCTACCTCTT	ASCIIString["CCTACCTCTTT"]
GGTTAGCACGA	ASCIIString["GTTAGCACGAC"]
CCTACCTCTTT	ASCIIString["CTACCTCTTTG"]
TTTCGTAAGAC	ASCIIString["TTCGTAAGACG"]
GGATGTAGCAG	ASCIIString["GATGTAGCAGG"]
GCTTATGCCTA	ASCIIString["CTTATGCCTAG"]
TGTGCGGTCGC	ASCIIString["GTGCGGTCGCA"]
CCATGTCAAGA	ASCIIString["CATGTCAAGAA"]
AGCTGGCGAGC	ASCIIString["GCTGGCGAGCC"]
AAATGCGCAGG	ASCIIString["AATGCGCAGGT"]
GGACCCAGTCT	ASCIIString["GACCCAGTCTG"]
GTTCTGCGGAC	ASCIIString["TTCTGCGGACC"]
AGAGGTTAGCA	ASCIIString["GAGGTTAGCAC"]
ACCTGGACTAA	ASCIIString["CCTGGACTAAG"]
TCAAAACAAAT	ASCIIString["CAAAACAAATT"]
GTGCCTGTTAA	ASCIIString["TGCCTGTTAAC"]
GGGGTCGGAGT	ASCIIString["GGGTCGGAGTC"]
CAGGTCACGGC	ASCIIString["AGGTCACGGCT"]
GGGTTGGCAAG	ASCIIString["GGTTGGCAAGC"]
CTAACGGGGCC	ASCIIString["TAACGGGGCCC"]
CATCCCCCCCC	ASCIIString["ATCCCCCCCCT"]
GCAGAACAACA	ASCIIString["CAGAACAACAA"]
GGTGCTGTGTA	ASCIIString["GTGCTGTGTAC"]
AATTCGTGCCT	ASCIIString["ATTCGTGCCTG"]
ATAACGATGAT	ASCIIString["TAACGATGATA"]
ACATGTCAGGT	ASCIIString["CATGTCAGGTC"]
GGCGAGCCCCA	ASCIIString["GCGAGCCCCAT"]
CTGCACGCAGC	ASCIIString["TGCACGCAGCA"]
ATGTAGCAACA	ASCIIString["TGTAGCAACAC"]
CAGCCTAGTCC	ASCIIString["AGCCTAGTCCT"]
GGGTGTTGGTC	ASCIIString["GGTGTTGGTCT"]
ACCCACGACCG	ASCIIString["CCCACGACCGC"]
TGGGTTGGCAA	ASCIIString["GGGTTGGCAAG"]
TATTAGGAGGA	ASCIIString["ATTAGGAGGAT"]
GGAGGAGTGTG	ASCIIString["GAGGAGTGTGC"]
TGGAGGTTCTA	ASCIIString["GGAGGTTCTAT"]
AGGCCTTCAAA	ASCIIString["GGCCTTCAAAA"]
ACACATAAGTA	ASCIIString["CACATAAGTAT"]
CGGCGGAGATG	ASCIIString["GGCGGAGATGT"]
GAAAGTTGTTC	ASCIIString["AAAGTTGTTCC"]
GAAGGCTAAGC	ASCIIString["AAGGCTAAGCT"]
TCAAGATTTAA	ASCIIString["CAAGATTTAAC"]
GAGGATGTAGC	ASCIIString["AGGATGTAGCA"]
AACCTGCGGTA	ASCIIString["ACCTGCGGTAG"]
CAGGGTACTCC	ASCIIString["AGGGTACTCCT"]
AATGAGAGGCG	ASCIIString["ATGAGAGGCGC"]
AGAGGATACAG	ASCIIString["GAGGATACAGT"]
AGGTCAGGAAT	ASCIIString["GGTCAGGAATA"]
GTTCAGCAGCT	ASCIIString["TTCAGCAGCTG"]
ACACGTGTCTC	ASCIIString["CACGTGTCTCA"]
TGGTGACGGCC	ASCIIString["GGTGACGGCCG"]
GAGAGGCGCCT	ASCIIString["AGAGGCGCCTG"]
GCCATACGTGC	ASCIIString["CCATACGTGCT"]
TAATCGGGGCA	ASCIIString["AATCGGGGCAA"]
CGTGTCTCAGC	ASCIIString["GTGTCTCAGCC"]
GCGGTAGTAGA	ASCIIString["CGGTAGTAGAG"]
GCCAGATAGAC	ASCIIString["CCAGATAGACG"]
GATCTAAACAG	ASCIIString["ATCTAAACAGG"]
CCACTAATCGA	ASCIIString["CACTAATCGAT"]
TACTGTGGGTG	ASCIIString["ACTGTGGGTGC"]
ACGGCTGCCAT	ASCIIString["CGGCTGCCATA"]
CGGGTAATCGG	ASCIIString["GGGTAATCGGG"]
TGGCGAGCCAT	ASCIIString["GGCGAGCCATC"]
CGATACATGAT	ASCIIString["GATACATGATG"]
CTAGGCAACGG	ASCIIString["TAGGCAACGGA"]
AGAATTATCCT	ASCIIString["GAATTATCCTC"]
GTCCCCATCTG	ASCIIString["TCCCCATCTGG"]
CCCCAGGTCAG	ASCIIString["CCCAGGTCAGG"]
ATACTATATGG	ASCIIString["TACTATATGGA"]
TTGAGGTGGCG	ASCIIString["TGAGGTGGCGT"]
CCTCCCAACTT	ASCIIString["CTCCCAACTTC"]
GACCCGGCACA	ASCIIString["ACCCGGCACAC"]
GTTGGCAAGCT	ASCIIString["TTGGCAAGCTA"]
GCCGAAGACGT	ASCIIString["CCGAAGACGTA"]
AACGGAGCTCC	ASCIIString["ACGGAGCTCCT"]
CGAAAAACATA	ASCIIString["GAAAAACATAT"]
TTGCGGCGGAG	ASCIIString["TGCGGCGGAGA"]
TAATGAGAGGC	ASCIIString["AATGAGAGGCG"]
GAAAAAGGGAT	ASCIIString["AAAAAGGGATA"]
TGTGCATAGAA	ASCIIString["GTGCATAGAAG"]
TCGGAGTCGGC	ASCIIString["CGGAGTCGGCC"]
TAATCGTTCAA	ASCIIString["AATCGTTCAAT"]
CAAGCCAGATC	ASCIIString["AAGCCAGATCG"]
ATAATATGATG	ASCIIString["TAATATGATGT"]
CAAACACCGAC	ASCIIString["AAACACCGACG"]
AATCGGGGCAA	ASCIIString["ATCGGGGCAAC"]
GCGTACGGTGA	ASCIIString["CGTACGGTGAC"]
TTAACCTGCGG	ASCIIString["TAACCTGCGGT"]
TAGCGATCAGG	ASCIIString["AGCGATCAGGG"]
GGCAGGGGAAA	ASCIIString["GCAGGGGAAAA"]
AGTCCCCATCT	ASCIIString["GTCCCCATCTG"]
CACGTGTCTCA	ASCIIString["ACGTGTCTCAG"]
GCAGCTCTAAT	ASCIIString["CAGCTCTAATT"]
ACAGTTAACTC	ASCIIString["CAGTTAACTCG"]
GTTCAATGAGC	ASCIIString["TTCAATGAGCG"]
GGGGTGTTGGT	ASCIIString["GGGTGTTGGTC"]
CATGTTATAAG	ASCIIString["ATGTTATAAGA"]
GTCCTATGTTT	ASCIIString["TCCTATGTTTC"]
CGGCTACGACT	ASCIIString["GGCTACGACTC"]
CACTAATCGAT	ASCIIString["ACTAATCGATT"]
ATGTTGCTGCG	ASCIIString["TGTTGCTGCGG"]
TGTCAAGCCAG	ASCIIString["GTCAAGCCAGA"]
CCTCCTCTGTC	ASCIIString["CTCCTCTGTCT"]
CACGACTTGCG	ASCIIString["ACGACTTGCGG"]
GGCGTGGCGGT	ASCIIString["GCGTGGCGGTT"]
GGTACCTCTGC	ASCIIString["GTACCTCTGCA"]
GGCAAGCTATC	ASCIIString["GCAAGCTATCC"]
CTCCGTGCCCG	ASCIIString["TCCGTGCCCGC"]
GACTTGCGGCG	ASCIIString["ACTTGCGGCGG"]
CTCCATCGCAA	ASCIIString["TCCATCGCAAT"]
CAACACAGAAC	ASCIIString["AACACAGAACA"]
GGGGATGTTCA	ASCIIString["GGGATGTTCAT"]
TCAGGTCATGT	ASCIIString["CAGGTCATGTA"]
TACCTAACGGG	ASCIIString["ACCTAACGGGG"]
GGGGCCCTCCC	ASCIIString["GGGCCCTCCCA"]
GGAAGGGGTGT	ASCIIString["GAAGGGGTGTT"]
CCCACATCTCA	ASCIIString["CCACATCTCAA"]
GTCAGTGGAGC	ASCIIString["TCAGTGGAGCC"]
AGTCAGTGGAG	ASCIIString["GTCAGTGGAGC"]
CGCGCGAGAGT	ASCIIString["GCGCGAGAGTT"]
TCAAATGCGCA	ASCIIString["CAAATGCGCAG"]
TTTCTTATCAG	ASCIIString["TTCTTATCAGT"]
TTGAAGTAGCT	ASCIIString["TGAAGTAGCTA"]
ACCTCCCTCCA	ASCIIString["CCTCCCTCCAG"]
GCCTGGTAGCG	ASCIIString["CCTGGTAGCGA"]
AGTACGATTGA	ASCIIString["GTACGATTGAG"]
GAAGCTAGTGA	ASCIIString["AAGCTAGTGAA"]
GGACCTGGACT	ASCIIString["GACCTGGACTA"]
GTTGCCTGGTA	ASCIIString["TTGCCTGGTAG"]
GGAAAGTTGTT	ASCIIString["GAAAGTTGTTC"]
ATAAGAGGGAG	ASCIIString["TAAGAGGGAGG"]
ATCCCACAGTT	ASCIIString["TCCCACAGTTC"]
ATGTTTCCATC	ASCIIString["TGTTTCCATCT"]
GCTGGATCATG	ASCIIString["CTGGATCATGG"]
GTGGTTGTAGG	ASCIIString["TGGTTGTAGGC"]
AGATTTAACCA	ASCIIString["GATTTAACCAC"]
TCAATGTTGCT	ASCIIString["CAATGTTGCTG"]
AACCGTTCCTC	ASCIIString["ACCGTTCCTCG"]
AATTGTCAAGC	ASCIIString["ATTGTCAAGCC"]
GGAGTCGGACC	ASCIIString["GAGTCGGACCT"]
TAGTAGGTTTC	ASCIIString["AGTAGGTTTCT"]
TGAATCGAAAC	ASCIIString["GAATCGAAACA"]
TCTCCGTGCCC	ASCIIString["CTCCGTGCCCG"]
CGTTCCTCGAT	ASCIIString["GTTCCTCGATA"]
CAAGAGTCTCC	ASCIIString["AAGAGTCTCCG"]
GGCAGAACAAC	ASCIIString["GCAGAACAACA"]
TCCTCTTGTAC	ASCIIString["CCTCTTGTACC"]
GACGTACGGGG	ASCIIString["ACGTACGGGGG"]
CGGGCAGGGGA	ASCIIString["GGGCAGGGGAA"]
ACTTTTCTCTC	ASCIIString["CTTTTCTCTCC"]
GTCTGTTTTCG	ASCIIString["TCTGTTTTCGA"]
TTATAAATCCA	ASCIIString["TATAAATCCAG"]
ACTTTCATGCT	ASCIIString["CTTTCATGCTC"]
GAGGATACAGT	ASCIIString["AGGATACAGTA"]
GTTAGCACGAC	ASCIIString["TTAGCACGACT"]
GCCTTCTATGA	ASCIIString["CCTTCTATGAT"]
GGTCATGTACT	ASCIIString["GTCATGTACTG"]
CACGCAGTTCT	ASCIIString["ACGCAGTTCTG"]
CACCAAACACC	ASCIIString["ACCAAACACCG"]
TGGAAGGGGTG	ASCIIString["GGAAGGGGTGT"]
GGAGCCAGATA	ASCIIString["GAGCCAGATAG"]
AGGACTCTGTG	ASCIIString["GGACTCTGTGT"]
GCCATTCCTCC	ASCIIString["CCATTCCTCCC"]
CGACCGCGTAC	ASCIIString["GACCGCGTACC"]
CTGGCGAGCCC	ASCIIString["TGGCGAGCCCC"]
CATTGGAACCT	ASCIIString["ATTGGAACCTC"]
CAGCTTGACAG	ASCIIString["AGCTTGACAGA"]
CGTCCATCCTT	ASCIIString["GTCCATCCTTT"]
GTACGGAATAT	ASCIIString["TACGGAATATC"]
CTTTGAAGTAG	ASCIIString["TTTGAAGTAGC"]
CAAGCAGCATC	ASCIIString["AAGCAGCATCA"]
ATCTCAAATGC	ASCIIString["TCTCAAATGCG"]
GTTTCCATCTG	ASCIIString["TTTCCATCTGG"]
CCATTCTTGGT	ASCIIString["CATTCTTGGTC"]
ATCAGGGTACT	ASCIIString["TCAGGGTACTC"]
ATAGGGAGGAG	ASCIIString["TAGGGAGGAGT"]
CTGTGTACGGA	ASCIIString["TGTGTACGGAA"]
TACGGGGGAGA	ASCIIString["ACGGGGGAGAG"]
AAGGGAGTCGG	ASCIIString["AGGGAGTCGGA"]
GTGCTGTGTAC	ASCIIString["TGCTGTGTACG"]
AAACACCGACG	ASCIIString["AACACCGACGA"]
ATACATGATGG	ASCIIString["TACATGATGGT"]
GGTAATCGGGG	ASCIIString["GTAATCGGGGC"]
TGTATACGGCC	ASCIIString["GTATACGGCCT"]
ACAGGCACGAT	ASCIIString["CAGGCACGATA"]
TGATGTGCGGT	ASCIIString["GATGTGCGGTC"]
AGGTCGGAGAT	ASCIIString["GGTCGGAGATC"]
TACGGCCTTCT	ASCIIString["ACGGCCTTCTC"]
CGAGCCCCATT	ASCIIString["GAGCCCCATTC"]
AAGGCTAAGCT	ASCIIString["AGGCTAAGCTG"]
ATCACCAAACA	ASCIIString["TCACCAAACAC"]
CCTACTACCCG	ASCIIString["CTACTACCCGT"]
AACCGCTGGCA	ASCIIString["ACCGCTGGCAG"]
ATGATGTGCGG	ASCIIString["TGATGTGCGGT"]
GGGATGTTCAT	ASCIIString["GGATGTTCATC"]
CCAGATCGGCA	ASCIIString["CAGATCGGCAT"]
ACCTCTGCACG	ASCIIString["CCTCTGCACGC"]
AGAAGCTAGTG	ASCIIString["GAAGCTAGTGA"]
AGGTGCCATTC	ASCIIString["GGTGCCATTCC"]
GAGGTCCCATG	ASCIIString["AGGTCCCATGT"]
GCGATACATGA	ASCIIString["CGATACATGAT"]
TCCTCGATAAC	ASCIIString["CCTCGATAACT"]
GCACGATAGCC	ASCIIString["CACGATAGCCC"]
ATCTGGGTATA	ASCIIString["TCTGGGTATAG"]
TCCAGCAGCAG	ASCIIString["CCAGCAGCAGC"]
CAGTGTTTGAG	ASCIIString["AGTGTTTGAGA"]
TTGTAGGCAAG	ASCIIString["TGTAGGCAAGA"]
TTAACCACTAA	ASCIIString["TAACCACTAAG"]
GCATGCCATTC	ASCIIString["CATGCCATTCC"]
GTCAAGAAATA	ASCIIString["TCAAGAAATAA"]
CTCGAAAAACA	ASCIIString["TCGAAAAACAT"]
CTCAGCCAGAA	ASCIIString["TCAGCCAGAAG"]
TAACTCGTGTC	ASCIIString["AACTCGTGTCC"]
TTGTGCGCCAA	ASCIIString["TGTGCGCCAAG"]
GAAAAGAGATC	ASCIIString["AAAAGAGATCC"]
CGTACGGGGGA	ASCIIString["GTACGGGGGAG"]
AACATTACGCA	ASCIIString["ACATTACGCAT"]
AAAAGAGGATA	ASCIIString["AAAGAGGATAC"]
CTGGCAGCTTG	ASCIIString["TGGCAGCTTGA"]
TGTAGGCAAGA	ASCIIString["GTAGGCAAGAG"]
AGGATACAGTA	ASCIIString["GGATACAGTAC"]
CCGCGCGAGAG	ASCIIString["CGCGCGAGAGT"]
AAAAGGGATAC	ASCIIString["AAAGGGATACA"]
AGAGGCCATCC	ASCIIString["GAGGCCATCCT"]
GACGAGGCGAT	ASCIIString["ACGAGGCGATA"]
TTCGTGCCTGT	ASCIIString["TCGTGCCTGTT"]
CAAAACAAATT	ASCIIString["AAAACAAATTA"]
CATCCTACTAC	ASCIIString["ATCCTACTACC"]
CCTTTCAACCG	ASCIIString["CTTTCAACCGC"]
GTGGAGCCAGA	ASCIIString["TGGAGCCAGAT"]
GGTTTCTAGGC	ASCIIString["GTTTCTAGGCC"]
TAACCCACGAC	ASCIIString["AACCCACGACC"]
ACAGAACAGTG	ASCIIString["CAGAACAGTGC"]
AAGTTGCGGGT	ASCIIString["AGTTGCGGGTA"]
TGTTTGCATGC	ASCIIString["GTTTGCATGCC"]
CACGTGTCCGG	ASCIIString["ACGTGTCCGGA"]
AACTTTCATGC	ASCIIString["ACTTTCATGCT"]
CGGCACACATA	ASCIIString["GGCACACATAA"]
CAGCTCTAATT	ASCIIString["AGCTCTAATTC"]
GCAGCACGCAG	ASCIIString["CAGCACGCAGT"]
AATAACCCACG	ASCIIString["ATAACCCACGA"]
GTTGAACCAGT	ASCIIString["TTGAACCAGTG"]
TCCCATGTCAA	ASCIIString["CCCATGTCAAG"]
TAAGGCGTGGC	ASCIIString["AAGGCGTGGCG"]
TATATAACCGC	ASCIIString["ATATAACCGCT"]
ATTGAGGTGGC	ASCIIString["TTGAGGTGGCG"]
CAAGGGAGTCG	ASCIIString["AAGGGAGTCGG"]
AAACCTACCTC	ASCIIString["AACCTACCTCT"]
AAAACTATAAT	ASCIIString["AAACTATAATC"]
CCACATCTCAA	ASCIIString["CACATCTCAAA"]
TACGAATACGT	ASCIIString["ACGAATACGTA"]
CTATCCGGCTC	ASCIIString["TATCCGGCTCA"]
CTGTTAACCTG	ASCIIString["TGTTAACCTGC"]
TGCGCCAAGGG	ASCIIString["GCGCCAAGGGA"]
AACCAGTGGAT	ASCIIString["ACCAGTGGATG"]
GGCCATACGTG	ASCIIString["GCCATACGTGC"]
AGAGTTGCAAG	ASCIIString["GAGTTGCAAGT"]
AAATAACCCAC	ASCIIString["AATAACCCACG"]
GGATCATGGTG	ASCIIString["GATCATGGTGA"]
GCTGCGGACCC	ASCIIString["CTGCGGACCCG"]
TACAACACTAT	ASCIIString["ACAACACTATC"]
GGCAAGAGTCT	ASCIIString["GCAAGAGTCTC"]
ACCAGTGGATG	ASCIIString["CCAGTGGATGA"]
CTATTCGTTGA	ASCIIString["TATTCGTTGAA"]
TTCAACCGCTT	ASCIIString["TCAACCGCTTG"]
GGCGTACGGTG	ASCIIString["GCGTACGGTGA"]
TTCTATGATTT	ASCIIString["TCTATGATTTG"]
CTGGGGATGTT	ASCIIString["TGGGGATGTTC"]
GAGAGAACCGT	ASCIIString["AGAGAACCGTT"]
GATGTTCATCC	ASCIIString["ATGTTCATCCC"]
AGAGAAAAGAG	ASCIIString["GAGAAAAGAGA"]
AGGTCAGGTGA	ASCIIString["GGTCAGGTGAG"]
TTTGAGAGAGG	ASCIIString["TTGAGAGAGGT"]
CACGATAGCCC	ASCIIString["ACGATAGCCCC"]
GTTTATAAATC	ASCIIString["TTTATAAATCC"]
CAGTGGATGAA	ASCIIString["AGTGGATGAAA"]
AGTGGATGAAA	ASCIIString["GTGGATGAAAA"]
TGGCAGCTTGA	ASCIIString["GGCAGCTTGAC"]
GAGGAGTGTGC	ASCIIString["AGGAGTGTGCT"]
AGAACAACAAG	ASCIIString["GAACAACAAGC"]
AAAACATATAT	ASCIIString["AAACATATATA"]
AGTTAGCCAAC	ASCIIString["GTTAGCCAACT"]
GATACAGCTAA	ASCIIString["ATACAGCTAAA"]
TACATGATGGT	ASCIIString["ACATGATGGTC"]
TTAAAACTATA	ASCIIString["TAAAACTATAA"]
ATTACGCATGA	ASCIIString["TTACGCATGAA"]
GTTTGAGAGAG	ASCIIString["TTTGAGAGAGG"]
GTAGGCAAACC	ASCIIString["TAGGCAAACCT"]
ACGAGGCGATA	ASCIIString["CGAGGCGATAC"]
GTCGGAGATCC	ASCIIString["TCGGAGATCCC"]
TCTTTGCCTTC	ASCIIString["CTTTGCCTTCT"]
AGAATGCTTTC	ASCIIString["GAATGCTTTCG"]
ACTCATTGGAA	ASCIIString["CTCATTGGAAC"]
AAACATATATA	ASCIIString["AACATATATAA"]
ACAAATTAAGA	ASCIIString["CAAATTAAGAG"]
GGGAGAGGCCA	ASCIIString["GGAGAGGCCAT"]
GCGCCTGGGGA	ASCIIString["CGCCTGGGGAT"]
GCGAGCCCCAT	ASCIIString["CGAGCCCCATT"]
ACATAAGTATT	ASCIIString["CATAAGTATTG"]
AGTTCCTTCAC	ASCIIString["GTTCCTTCACA"]
CAAAAACTTTT	ASCIIString["AAAAACTTTTC"]
ATAGACGTCCA	ASCIIString["TAGACGTCCAT"]
TCGTTCAATGA	ASCIIString["CGTTCAATGAG"]
GTCGGCCATAC	ASCIIString["TCGGCCATACG"]
CTCAATGTTGC	ASCIIString["TCAATGTTGCT"]
CGGTCGCACAT	ASCIIString["GGTCGCACATA"]
TGCGGACCCGG	ASCIIString["GCGGACCCGGC"]
GAACGCTTATG	ASCIIString["AACGCTTATGC"]
AGCGAGGAGTT	ASCIIString["GCGAGGAGTTC"]
TGAGAGGCGCC	ASCIIString["GAGAGGCGCCT"]
GACCGCGTACC	ASCIIString["ACCGCGTACCC"]
CTCTGTGTGGC	ASCIIString["TCTGTGTGGCG"]
ATGCTCGAAAA	ASCIIString["TGCTCGAAAAA"]
GCCATAGTAGG	ASCIIString["CCATAGTAGGT"]
TACGGAATATC	ASCIIString["ACGGAATATCA"]
GTGGCGTACGG	ASCIIString["TGGCGTACGGT"]
CTACCACTAAT	ASCIIString["TACCACTAATC"]
AAGAGCGTCGA	ASCIIString["AGAGCGTCGAG"]
AAAACAAAACA	ASCIIString["AAACAAAACAG"]
CCATAGTAGGT	ASCIIString["CATAGTAGGTT"]
CGCAGTACGAT	ASCIIString["GCAGTACGATT"]
GCGTACCCACA	ASCIIString["CGTACCCACAT"]
GGCATAATGAG	ASCIIString["GCATAATGAGA"]
GTGGAAAGTTG	ASCIIString["TGGAAAGTTGT"]
CAGTGAAACTT	ASCIIString["AGTGAAACTTA"]
GTTGCAAGTGT	ASCIIString["TTGCAAGTGTT"]
TTCCCGCAGTA	ASCIIString["TCCCGCAGTAC"]
CTGTGCATAGA	ASCIIString["TGTGCATAGAA"]
CGATAACTGGT	ASCIIString["GATAACTGGTG"]
AATTAGTTAGC	ASCIIString["ATTAGTTAGCG"]
AAGGCGTGGCG	ASCIIString["AGGCGTGGCGG"]
GGGCAACAAGG	ASCIIString["GGCAACAAGGT"]
GATGTAGCAGG	ASCIIString["ATGTAGCAGGG"]
AAGAAATAATA	ASCIIString["AGAAATAATAT"]
TTCGAAAGGCA	ASCIIString["TCGAAAGGCAG"]
CAACACTATCA	ASCIIString["AACACTATCAG"]
CTGCGGACCCG	ASCIIString["TGCGGACCCGG"]
ATTCTTGGTCA	ASCIIString["TTCTTGGTCAC"]
ATAAGTATTGA	ASCIIString["TAAGTATTGAG"]
ACTCTGTGTGG	ASCIIString["CTCTGTGTGGC"]
TCCACGTGGAA	ASCIIString["CCACGTGGAAA"]
CATGTATACGG	ASCIIString["ATGTATACGGC"]
CTGCGGACCTG	ASCIIString["TGCGGACCTGG"]
TTGTCCCGGTA	ASCIIString["TGTCCCGGTAC"]
AACAAGCAGCA	ASCIIString["ACAAGCAGCAT"]
CGCGTACCCAC	ASCIIString["GCGTACCCACA"]
AGAAATAATAT	ASCIIString["GAAATAATATG"]
CGATCTAAACA	ASCIIString["GATCTAAACAG"]
TAAAACTATAA	ASCIIString["AAAACTATAAT"]
CCTCATAGCTA	ASCIIString["CTCATAGCTAT"]
ACAGCTAAATC	ASCIIString["CAGCTAAATCT"]
CAGGGACCCAG	ASCIIString["AGGGACCCAGT"]
TCGATAACTGG	ASCIIString["CGATAACTGGT"]
TACCCGTATCG	ASCIIString["ACCCGTATCGT"]
CTTGGTCACAC	ASCIIString["TTGGTCACACG"]
TCCTCCTCTGT	ASCIIString["CCTCCTCTGTC"]
ACAACACTATC	ASCIIString["CAACACTATCA"]
AATAATATGAT	ASCIIString["ATAATATGATG"]
ACGCAGTTCTG	ASCIIString["CGCAGTTCTGC"]
CCTCTTTGTGC	ASCIIString["CTCTTTGTGCG"]
TCGGACCTATT	ASCIIString["CGGACCTATTC"]
TACACGTGTCT	ASCIIString["ACACGTGTCTC"]
CTTTACTGGGT	ASCIIString["TTTACTGGGTG"]
AGGCACGATAG	ASCIIString["GGCACGATAGC"]
GGCGGTTTATA	ASCIIString["GCGGTTTATAA"]
GTCAGGTGAGC	ASCIIString["TCAGGTGAGCG"]
AACCGCTTGGG	ASCIIString["ACCGCTTGGGT"]
GCTTCCCGCAG	ASCIIString["CTTCCCGCAGT"]
AGCGATCAGGG	ASCIIString["GCGATCAGGGT"]
ACGCGAACAAT	ASCIIString["CGCGAACAATT"]
CTACACGTGTC	ASCIIString["TACACGTGTCT"]
AACTATAATCG	ASCIIString["ACTATAATCGT"]
AACACCTACTT	ASCIIString["ACACCTACTTC"]
CGATTGGAGGT	ASCIIString["GATTGGAGGTT"]
AGTGTTTGAGA	ASCIIString["GTGTTTGAGAG"]
TCTCAATGTTG	ASCIIString["CTCAATGTTGC"]
AGCGTCGAGAG	ASCIIString["GCGTCGAGAGA"]
GAATCGAAACA	ASCIIString["AATCGAAACAC"]
ACCTGCGGTAG	ASCIIString["CCTGCGGTAGC"]
TCGATTGGAGG	ASCIIString["CGATTGGAGGT"]
CAGTGCGGGCA	ASCIIString["AGTGCGGGCAG"]
GCAGTTCTGCG	ASCIIString["CAGTTCTGCGG"]
CAGGGGAAAAA	ASCIIString["AGGGGAAAAAG"]
GATTGAGTCCC	ASCIIString["ATTGAGTCCCC"]
TGCGGCGGAGA	ASCIIString["GCGGCGGAGAT"]
TGAAAACAAAA	ASCIIString["GAAAACAAAAC"]
CCTCTGCACGC	ASCIIString["CTCTGCACGCA"]
TCCCGCAGTAC	ASCIIString["CCCGCAGTACG"]
TACCTCTTTGT	ASCIIString["ACCTCTTTGTG"]
CAAGTTGTTTG	ASCIIString["AAGTTGTTTGC"]
TACTGGGTGCG	ASCIIString["ACTGGGTGCGT"]
GCCAACTTTCA	ASCIIString["CCAACTTTCAT"]
CCAAGTTGTTT	ASCIIString["CAAGTTGTTTG"]
GGGACCCAGTC	ASCIIString["GGACCCAGTCT"]
CGGGGCCCTCC	ASCIIString["GGGGCCCTCCC"]
GATATGTCACG	ASCIIString["ATATGTCACGT"]
GCTAGTGCGAA	ASCIIString["CTAGTGCGAAA"]
GAAGTAGCTAG	ASCIIString["AAGTAGCTAGT"]
TGACCAAATAA	ASCIIString["GACCAAATAAC"]
AGACATGTCAG	ASCIIString["GACATGTCAGG"]
GCAACGGAGCT	ASCIIString["CAACGGAGCTC"]
CACAGGTCACG	ASCIIString["ACAGGTCACGG"]
CTTCCTTCTTT	ASCIIString["TTCCTTCTTTG"]
GCTCTAATTCG	ASCIIString["CTCTAATTCGT"]
AGGCCATCCTA	ASCIIString["GGCCATCCTAC"]
CCTATTACGAA	ASCIIString["CTATTACGAAT"]
TCCTTTGAAGT	ASCIIString["CCTTTGAAGTA"]
TTCATGTTATA	ASCIIString["TCATGTTATAA"]
TTTTCTCTCCA	ASCIIString["TTTCTCTCCAT"]
CCGGCTCAAAC	ASCIIString["CGGCTCAAACA"]
GCAAGAGTCTC	ASCIIString["CAAGAGTCTCC"]
CTTTCGTAAGA	ASCIIString["TTTCGTAAGAC"]
AACCTACCTCT	ASCIIString["ACCTACCTCTT"]
ACGGGGGAGAG	ASCIIString["CGGGGGAGAGG"]
AATGAGCGGTA	ASCIIString["ATGAGCGGTAG"]
TCTCAGCCAGA	ASCIIString["CTCAGCCAGAA"]
AGTGCGAAAGG	ASCIIString["GTGCGAAAGGT"]
AACGATGATAT	ASCIIString["ACGATGATATG"]
GCCAGAAGCTA	ASCIIString["CCAGAAGCTAG"]
TGAGAGAGGTT	ASCIIString["GAGAGAGGTTA"]
TATAAATCCAG	ASCIIString["ATAAATCCAGC"]
GAGGAGTTCAG	ASCIIString["AGGAGTTCAGC"]
GATAGACGTCC	ASCIIString["ATAGACGTCCA"]
TATGATTTGAG	ASCIIString["ATGATTTGAGG"]
GTGGATGAAAA	ASCIIString["TGGATGAAAAC"]
ACGGTGACCAA	ASCIIString["CGGTGACCAAA"]
CATATCAAGAT	ASCIIString["ATATCAAGATT"]
AAGCCAGATCG	ASCIIString["AGCCAGATCGG"]
ACATATATAAC	ASCIIString["CATATATAACC"]
AATGGAACGCT	ASCIIString["ATGGAACGCTT"]
TACAGCTAAAT	ASCIIString["ACAGCTAAATC"]
GTACAACACTA	ASCIIString["TACAACACTAT"]
ATTATCCTCTT	ASCIIString["TTATCCTCTTG"]
ATAGCCCCAGG	ASCIIString["TAGCCCCAGGT"]
ACAGTGCGGGC	ASCIIString["CAGTGCGGGCA"]
GATGTAGCAAC	ASCIIString["ATGTAGCAACA"]
TCTTTGTGCGC	ASCIIString["CTTTGTGCGCC"]
AGTTAGCGTAA	ASCIIString["GTTAGCGTAAC"]
ACATGATGGTC	ASCIIString["CATGATGGTCT"]
CGGCATAATGA	ASCIIString["GGCATAATGAG"]
AAGTTGTTCCA	ASCIIString["AGTTGTTCCAT"]
CGGTACCTCTG	ASCIIString["GGTACCTCTGC"]
GGACTAAGCCA	ASCIIString["GACTAAGCCAC"]
TAGCCAACTTT	ASCIIString["AGCCAACTTTC"]
AAGTAGCTAGT	ASCIIString["AGTAGCTAGTG"]
TGGAACCTCCC	ASCIIString["GGAACCTCCCT"]
CAATGTTGCTG	ASCIIString["AATGTTGCTGC"]
CACCGACGAGG	ASCIIString["ACCGACGAGGC"]
AAAAGAGATCC	ASCIIString["AAAGAGATCCA"]
GTACCTCTGCA	ASCIIString["TACCTCTGCAC"]
GTAGCGTGGTT	ASCIIString["TAGCGTGGTTG"]
ACAACAAGCAG	ASCIIString["CAACAAGCAGC"]
CAACAAGCAGC	ASCIIString["AACAAGCAGCA"]
GAATACGTATG	ASCIIString["AATACGTATGG"]
TGATGGTCTAC	ASCIIString["GATGGTCTACA"]
GAGGCCATCCT	ASCIIString["AGGCCATCCTA"]
AAGAGGGAGGA	ASCIIString["AGAGGGAGGAG"]
TGTGCGCCAAG	ASCIIString["GTGCGCCAAGG"]
GCCTAGGCAAC	ASCIIString["CCTAGGCAACG"]
GCCTATTACGA	ASCIIString["CCTATTACGAA"]
GGTAGCGATTT	ASCIIString["GTAGCGATTTC"]
TGGAAAGTTGT	ASCIIString["GGAAAGTTGTT"]
ATGTAGCAGGG	ASCIIString["TGTAGCAGGGA"]
AGGGAGGAGGT	ASCIIString["GGGAGGAGGTC"]
TCATGTTATAA	ASCIIString["CATGTTATAAG"]
GGAGTTCAGCA	ASCIIString["GAGTTCAGCAG"]
AACTGGTGTAC	ASCIIString["ACTGGTGTACG"]
AGGTTTCTAGG	ASCIIString["GGTTTCTAGGC"]
CAGTGGAGCCA	ASCIIString["AGTGGAGCCAG"]
ATCGTTCAATG	ASCIIString["TCGTTCAATGA"]
GCCAAGGGAGT	ASCIIString["CCAAGGGAGTC"]
AGCGTTTAATA	ASCIIString["GCGTTTAATAT"]
CTACTTCACCG	ASCIIString["TACTTCACCGT"]
TAACTGAGAGA	ASCIIString["AACTGAGAGAA"]
ATAACTGGTGT	ASCIIString["TAACTGGTGTA"]
CCGCTGGCAGC	ASCIIString["CGCTGGCAGCT"]
GTATGGTCCTC	ASCIIString["TATGGTCCTCC"]
TACGTATGGTC	ASCIIString["ACGTATGGTCC"]
TGATTTGAGGT	ASCIIString["GATTTGAGGTG"]
TAGTAGGCAAA	ASCIIString["AGTAGGCAAAC"]
CATGGTGACGG	ASCIIString["ATGGTGACGGC"]
TCCCTTTACTG	ASCIIString["CCCTTTACTGG"]
GTAGCTAGTGC	ASCIIString["TAGCTAGTGCG"]
TGGCGGTTTAT	ASCIIString["GGCGGTTTATA"]
CGTAACTACCA	ASCIIString["GTAACTACCAC"]
CTACGACTCAT	ASCIIString["TACGACTCATT"]
GCGGTAGCGTG	ASCIIString["CGGTAGCGTGG"]
GTCTCAATGTT	ASCIIString["TCTCAATGTTG"]
GGCGATACATG	ASCIIString["GCGATACATGA"]
CATGTCAGGTC	ASCIIString["ATGTCAGGTCA"]
CTCCTCTGTCT	ASCIIString["TCCTCTGTCTG"]
GCGGCGGAGAT	ASCIIString["CGGCGGAGATG"]
GTGTGGCGAGC	ASCIIString["TGTGGCGAGCC"]
GATGGTCTACA	ASCIIString["ATGGTCTACAC"]
ACTGTGGGTGC	ASCIIString["CTGTGGGTGCT"]
CGTATGGTCCT	ASCIIString["GTATGGTCCTC"]
TCTGGGTATAG	ASCIIString["CTGGGTATAGA"]
CGAAAGGCAGA	ASCIIString["GAAAGGCAGAA"]
ATGGTGACGGC	ASCIIString["TGGTGACGGCC"]
CATCAGTGAAA	ASCIIString["ATCAGTGAAAC"]
GGGATACAGTT	ASCIIString["GGATACAGTTG"]
GCCATCAGTGA	ASCIIString["CCATCAGTGAA"]
AGTTCTGCGGA	ASCIIString["GTTCTGCGGAC"]
TAGGCAAGAGT	ASCIIString["AGGCAAGAGTC"]
AGTAGCTAGTG	ASCIIString["GTAGCTAGTGC"]
TCGGCCATACG	ASCIIString["CGGCCATACGT"]
TGGTCACACGT	ASCIIString["GGTCACACGTT"]
GCGGGTAATCG	ASCIIString["CGGGTAATCGG"]
CGCGAACAATT	ASCIIString["GCGAACAATTG"]
TATGTTTCCAT	ASCIIString["ATGTTTCCATC"]
TCTAAACAGGC	ASCIIString["CTAAACAGGCA"]
GCGGACCTGGA	ASCIIString["CGGACCTGGAC"]
ACATCTCAAAT	ASCIIString["CATCTCAAATG"]
CAAATGCGCAG	ASCIIString["AAATGCGCAGG"]
GACCTGGACTA	ASCIIString["ACCTGGACTAA"]
ATAACCGCTGG	ASCIIString["TAACCGCTGGC"]
TCACAGTTAAC	ASCIIString["CACAGTTAACT"]
TTCCTTCTTTG	ASCIIString["TCCTTCTTTGC"]
AATAGGGAGGA	ASCIIString["ATAGGGAGGAG"]
CAGTTCCTTCA	ASCIIString["AGTTCCTTCAC"]
ATGTTCATCCC	ASCIIString["TGTTCATCCCC"]
ACCTATTCGTT	ASCIIString["CCTATTCGTTG"]
AGCAGCATCAC	ASCIIString["GCAGCATCACC"]
CTTGTACCAAG	ASCIIString["TTGTACCAAGC"]
ACCTAACGGGG	ASCIIString["CCTAACGGGGC"]
ACACAGAACAG	ASCIIString["CACAGAACAGT"]
CATAAGGCGTG	ASCIIString["ATAAGGCGTGG"]
GCACATAATGG	ASCIIString["CACATAATGGA"]
ACGTGCTTATA	ASCIIString["CGTGCTTATAA"]
GTGAAACTTAG	ASCIIString["TGAAACTTAGT"]
TTTCCATCTGG	ASCIIString["TTCCATCTGGA"]
CAACGGAGCTC	ASCIIString["AACGGAGCTCC"]
CGGTGGATACA	ASCIIString["GGTGGATACAG"]
GGGAGGAGGTC	ASCIIString["GGAGGAGGTCG"]
CTTTTCTCTCC	ASCIIString["TTTTCTCTCCA"]
TCCTTCTTTGC	ASCIIString["CCTTCTTTGCC"]
AGGAGTTCAGC	ASCIIString["GGAGTTCAGCA"]
ATATCAAGATT	ASCIIString["TATCAAGATTT"]
TCTTATCAGTC	ASCIIString["CTTATCAGTCA"]
GAGAGGCCATC	ASCIIString["AGAGGCCATCC"]
ATTCGTGCCTG	ASCIIString["TTCGTGCCTGT"]
TGTCCATAGGT	ASCIIString["GTCCATAGGTG"]
GGCGGAGATGT	ASCIIString["GCGGAGATGTA"]
GTTAAGGACTC	ASCIIString["TTAAGGACTCT"]
GGCAGCTTGAC	ASCIIString["GCAGCTTGACA"]
TAGCACGACTT	ASCIIString["AGCACGACTTG"]
ACACTATCAGT	ASCIIString["CACTATCAGTG"]
GCAGCTGGATC	ASCIIString["CAGCTGGATCA"]
AAAAACTTTTC	ASCIIString["AAAACTTTTCT"]
TGTACTGTGGG	ASCIIString["GTACTGTGGGT"]
TAGTGCGAAAG	ASCIIString["AGTGCGAAAGG"]
CCGTTCCTCGA	ASCIIString["CGTTCCTCGAT"]
AAGCAGCATCA	ASCIIString["AGCAGCATCAC"]
TTCCTCCCCTC	ASCIIString["TCCTCCCCTCA"]
GCATGAAAAGA	ASCIIString["CATGAAAAGAG"]
TTTTCGAAAGG	ASCIIString["TTTCGAAAGGC"]
GCTATAACGAT	ASCIIString["CTATAACGATG"]
GGCAATTAGTT	ASCIIString["GCAATTAGTTA"]
ACTCGTGTCCA	ASCIIString["CTCGTGTCCAT"]
AGCTATTAGGA	ASCIIString["GCTATTAGGAG"]
TGTTTGAGAGA	ASCIIString["GTTTGAGAGAG"]
GTGAGGTCCCA	ASCIIString["TGAGGTCCCAT"]
AACACCGACGA	ASCIIString["ACACCGACGAG"]
GCCTTCAAAAC	ASCIIString["CCTTCAAAACA"]
CAGTACGATTG	ASCIIString["AGTACGATTGA"]
CGAGAGAAAAG	ASCIIString["GAGAGAAAAGA"]
GTCTGAGCTAT	ASCIIString["TCTGAGCTATA"]
GTCGCACATAA	ASCIIString["TCGCACATAAT"]
ATACAGTACCT	ASCIIString["TACAGTACCTA"]
GTGTTTGAGAG	ASCIIString["TGTTTGAGAGA"]
TCTGTGTGGCG	ASCIIString["CTGTGTGGCGA"]
TCCTATGTTTC	ASCIIString["CCTATGTTTCC"]
ACCGTTCCTCG	ASCIIString["CCGTTCCTCGA"]
GTACGAAGGCT	ASCIIString["TACGAAGGCTA"]
GGTAGTAGAGG	ASCIIString["GTAGTAGAGGG"]
TATATGGATGG	ASCIIString["ATATGGATGGC"]
TTAATATAGAG	ASCIIString["TAATATAGAGC"]
AAGAGATCCAC	ASCIIString["AGAGATCCACG"]
TGTCCGGAGGG	ASCIIString["GTCCGGAGGGG"]
TCACACGTTGC	ASCIIString["CACACGTTGCC"]
GCCAGATCGGC	ASCIIString["CCAGATCGGCA"]
CCTAGGCAACG	ASCIIString["CTAGGCAACGG"]
AACCTCCCTCC	ASCIIString["ACCTCCCTCCA"]
GAGTGTGCTTC	ASCIIString["AGTGTGCTTCC"]
ATATAACCGCT	ASCIIString["TATAACCGCTG"]
AGACGTACGGG	ASCIIString["GACGTACGGGG"]
TTAGTAGGCAA	ASCIIString["TAGTAGGCAAA"]
CACTAAGTTGC	ASCIIString["ACTAAGTTGCG"]
CGTGGAAAGTT	ASCIIString["GTGGAAAGTTG"]
GCATCACCAAA	ASCIIString["CATCACCAAAC"]
AAGTGTTCATG	ASCIIString["AGTGTTCATGT"]
GTCACACGTTG	ASCIIString["TCACACGTTGC"]
TGGATGGCAAT	ASCIIString["GGATGGCAATT"]
GGGGCAACAAG	ASCIIString["GGGCAACAAGG"]
GGAAGGCCTTC	ASCIIString["GAAGGCCTTCA"]
GCTTGACAGAT	ASCIIString["CTTGACAGATA"]
AGCAGCAGCGG	ASCIIString["GCAGCAGCGGT"]
CAATTGTCCCG	ASCIIString["AATTGTCCCGG"]
ATGGCAATTAG	ASCIIString["TGGCAATTAGT"]
CATTCCCTTTA	ASCIIString["ATTCCCTTTAC"]
ACGGAGCTCCT	ASCIIString["CGGAGCTCCTT"]
CCATCCTACTA	ASCIIString["CATCCTACTAC"]
AGGTTCTATCA	ASCIIString["GGTTCTATCAC"]
GTTGTTTGCAT	ASCIIString["TTGTTTGCATG"]
TGCGTGAGGTC	ASCIIString["GCGTGAGGTCC"]
CAGATCGGCAT	ASCIIString["AGATCGGCATA"]
TCATCCCCCCC	ASCIIString["CATCCCCCCCC"]
GGTCCCATGTC	ASCIIString["GTCCCATGTCA"]
GGCCCTCCCAA	ASCIIString["GCCCTCCCAAC"]
GCGGTTTATAA	ASCIIString["CGGTTTATAAA"]
GTCAGGTCATG	ASCIIString["TCAGGTCATGT"]
TGTCAGGTCAT	ASCIIString["GTCAGGTCATG"]
TGTGTACGGAA	ASCIIString["GTGTACGGAAT"]
TGAGCGGTAGT	ASCIIString["GAGCGGTAGTA"]
ATACAGCTAAA	ASCIIString["TACAGCTAAAT"]
CGGAGGGGCCC	ASCIIString["GGAGGGGCCCG"]
CTTCTTTGCCT	ASCIIString["TTCTTTGCCTT"]
AAGGTCAGGAA	ASCIIString["AGGTCAGGAAT"]
CGCCTGGGGAT	ASCIIString["GCCTGGGGATG"]
CAGCCAGAAGC	ASCIIString["AGCCAGAAGCT"]
GTTAAAACTAT	ASCIIString["TTAAAACTATA"]
CAAGGTACGAA	ASCIIString["AAGGTACGAAG"]
TCTTGGTCACA	ASCIIString["CTTGGTCACAC"]
GCCATCCTACT	ASCIIString["CCATCCTACTA"]
GAGAGGTTAGC	ASCIIString["AGAGGTTAGCA"]
AGATCGGCATA	ASCIIString["GATCGGCATAA"]
GGAACGCTTAT	ASCIIString["GAACGCTTATG"]
AAACAGTGACG	ASCIIString["AACAGTGACGC"]
CAGCAGCGGTG	ASCIIString["AGCAGCGGTGG"]
AGTGCGGGCAG	ASCIIString["GTGCGGGCAGG"]
TGTATGCAGCT	ASCIIString["GTATGCAGCTC"]
CTTTGCCTTCT	ASCIIString["TTTGCCTTCTA"]
ATCGAAACACC	ASCIIString["TCGAAACACCT"]
CATCTGGGTAT	ASCIIString["ATCTGGGTATA"]
TATGCAGCTCT	ASCIIString["ATGCAGCTCTA"]
GTGGCGGTTTA	ASCIIString["TGGCGGTTTAT"]
AGAAGAATGCT	ASCIIString["GAAGAATGCTT"]
GGTAGCGATCA	ASCIIString["GTAGCGATCAG"]
TCCATCTGGAT	ASCIIString["CCATCTGGATC"]
GAAAGGTCAGG	ASCIIString["AAAGGTCAGGA"]
CCAACTTTCAT	ASCIIString["CAACTTTCATG"]
GGGTGCTGTGT	ASCIIString["GGTGCTGTGTA"]
AAATAATATGA	ASCIIString["AATAATATGAT"]
TGGATACAGCT	ASCIIString["GGATACAGCTA"]
GCGATCAGGGT	ASCIIString["CGATCAGGGTA"]
GATTTGAGGTG	ASCIIString["ATTTGAGGTGT"]
CTACCTCTTTG	ASCIIString["TACCTCTTTGT"]
AGAGCGTCGAG	ASCIIString["GAGCGTCGAGA"]
TAATTGTCAAG	ASCIIString["AATTGTCAAGC"]
TCTCAAATGCG	ASCIIString["CTCAAATGCGC"]
GCGGTCGCACA	ASCIIString["CGGTCGCACAT"]
ACCGACGAGGC	ASCIIString["CCGACGAGGCG"]
GTGCTTCCCGC	ASCIIString["TGCTTCCCGCA"]
TCTGGATCTTC	ASCIIString["CTGGATCTTCC"]
CCAACTTCATG	ASCIIString["CAACTTCATGT"]
CCCCCCTAGAC	ASCIIString["CCCCCTAGACA"]
TTGTTCCATAT	ASCIIString["TGTTCCATATC"]
GTGACGCGAAC	ASCIIString["TGACGCGAACA"]
TAATATAGAGC	ASCIIString["AATATAGAGCC"]
AGTTGTTCCAT	ASCIIString["GTTGTTCCATA"]
AATATGATGTG	ASCIIString["ATATGATGTGC"]
TCCATCCTTTG	ASCIIString["CCATCCTTTGA"]
CTTTGTGCGCC	ASCIIString["TTTGTGCGCCA"]
ACTGGGTGCGT	ASCIIString["CTGGGTGCGTG"]
CGGGGGAGAGG	ASCIIString["GGGGGAGAGGC"]
AGTTGGTAGCG	ASCIIString["GTTGGTAGCGA"]
GCTGTGTACGG	ASCIIString["CTGTGTACGGA"]
GGCTAAGCTGG	ASCIIString["GCTAAGCTGGC"]
TATCAGTCAGT	ASCIIString["ATCAGTCAGTG"]
AATCGATTGGA	ASCIIString["ATCGATTGGAG"]
GGTAGCGTGGT	ASCIIString["GTAGCGTGGTT"]
GTAGCAACACA	ASCIIString["TAGCAACACAG"]
CGTATCGTTAA	ASCIIString["GTATCGTTAAG"]
TCCCAACTTCA	ASCIIString["CCCAACTTCAT"]
CGATGATATGT	ASCIIString["GATGATATGTC"]
CCTACTTCACC	ASCIIString["CTACTTCACCG"]
TCGAAAAACAT	ASCIIString["CGAAAAACATA"]
CCGTGCCCGCG	ASCIIString["CGTGCCCGCGC"]
CTCAAACATTA	ASCIIString["TCAAACATTAC"]
TGTCTGTTTTC	ASCIIString["GTCTGTTTTCG"]
CAAGCGTTTAA	ASCIIString["AAGCGTTTAAT"]
GCTAGTGAATC	ASCIIString["CTAGTGAATCG"]
CATGTCAAGAA	ASCIIString["ATGTCAAGAAA"]
TGTTGCTGCGG	ASCIIString["GTTGCTGCGGA"]
TGTTCCATATC	ASCIIString["GTTCCATATCA"]
AGCCCCATTCT	ASCIIString["GCCCCATTCTT"]
TTCTATCACAG	ASCIIString["TCTATCACAGT"]
TCGAAAGGCAG	ASCIIString["CGAAAGGCAGA"]
TTTGAAGTAGC	ASCIIString["TTGAAGTAGCT"]
GCTTTCGTAAG	ASCIIString["CTTTCGTAAGA"]
GTAAGACGATC	ASCIIString["TAAGACGATCT"]
TTGCAAGTGTT	ASCIIString["TGCAAGTGTTC"]
TAGACATGTCA	ASCIIString["AGACATGTCAG"]
TCATTGGAACC	ASCIIString["CATTGGAACCT"]
CTTATCAGTCA	ASCIIString["TTATCAGTCAG"]
TTGGTAGCGAT	ASCIIString["TGGTAGCGATT"]
GTGTTCATGTA	ASCIIString["TGTTCATGTAT"]
GGTCGGAGTCG	ASCIIString["GTCGGAGTCGG"]
AGAACAGTGCG	ASCIIString["GAACAGTGCGG"]
TGAAAAGAGGA	ASCIIString["GAAAAGAGGAT"]
GCTCGAAAAAC	ASCIIString["CTCGAAAAACA"]
AGGGAGGAGTG	ASCIIString["GGGAGGAGTGT"]
TGGGTATAGAA	ASCIIString["GGGTATAGAAT"]
CAGGTCAGGTG	ASCIIString["AGGTCAGGTGA"]
CAGCAGCTGGA	ASCIIString["AGCAGCTGGAT"]
GTCGGAGTCGG	ASCIIString["TCGGAGTCGGC"]
CAGCTAAATCT	ASCIIString["AGCTAAATCTG"]
CCCTTTACTGG	ASCIIString["CCTTTACTGGG"]
GGCAACGGAGC	ASCIIString["GCAACGGAGCT"]
AAAACAAATTA	ASCIIString["AAACAAATTAA"]
AGTACCTAACG	ASCIIString["GTACCTAACGG"]
AACACTATCAG	ASCIIString["ACACTATCAGT"]
TATGTCACGTG	ASCIIString["ATGTCACGTGT"]
GCAATAACTGA	ASCIIString["CAATAACTGAG"]
CGTCGAGAGAA	ASCIIString["GTCGAGAGAAA"]
CTATATGGATG	ASCIIString["TATATGGATGG"]
CGGAGCTCCTT	ASCIIString["GGAGCTCCTTT"]
TTGCCTGGTAG	ASCIIString["TGCCTGGTAGC"]
CAGCATCACCA	ASCIIString["AGCATCACCAA"]
CCTAACGGGGC	ASCIIString["CTAACGGGGCC"]
TTACTGGGTGC	ASCIIString["TACTGGGTGCG"]
CACTGCAAAAA	ASCIIString["ACTGCAAAAAC"]
TCTATGATTTG	ASCIIString["CTATGATTTGA"]
TAATATGATGT	ASCIIString["AATATGATGTG"]
CATAGCTATTA	ASCIIString["ATAGCTATTAG"]
AACGCTTATGC	ASCIIString["ACGCTTATGCC"]
CCGACGAGGCG	ASCIIString["CGACGAGGCGA"]
GTGAATCGAAA	ASCIIString["TGAATCGAAAC"]
GATCATGGTGA	ASCIIString["ATCATGGTGAC"]
GAGCGGTAGTA	ASCIIString["AGCGGTAGTAG"]
GGTCTACACGT	ASCIIString["GTCTACACGTG"]
AAAACAGTGAC	ASCIIString["AAACAGTGACG"]
GCTCAAACATT	ASCIIString["CTCAAACATTA"]
TAACGATGATA	ASCIIString["AACGATGATAT"]
CTTCACCGTTA	ASCIIString["TTCACCGTTAA"]
GAGGTTCTATC	ASCIIString["AGGTTCTATCA"]
ACCGCTTGGGT	ASCIIString["CCGCTTGGGTT"]
GATGAAAACAA	ASCIIString["ATGAAAACAAA"]
ATGTATACGGC	ASCIIString["TGTATACGGCC"]
GTACGGAATAC	ASCIIString["TACGGAATACT"]
TTCATGCTCGA	ASCIIString["TCATGCTCGAA"]
AGCGTAACTAC	ASCIIString["GCGTAACTACC"]
ATGAAAACAAA	ASCIIString["TGAAAACAAAA"]
ACTATCAGTGT	ASCIIString["CTATCAGTGTT"]
AACAATTGTCC	ASCIIString["ACAATTGTCCC"]
GGGGGTCGGAG	ASCIIString["GGGGTCGGAGT"]
GGATACAGTAC	ASCIIString["GATACAGTACC"]
CCTTTGAAGTA	ASCIIString["CTTTGAAGTAG"]
GGAATATCAGC	ASCIIString["GAATATCAGCC"]
CACATAATGGA	ASCIIString["ACATAATGGAA"]
TGCTTCCCGCA	ASCIIString["GCTTCCCGCAG"]
TCCCACAGTTC	ASCIIString["CCCACAGTTCC"]
CAATGAGCGGT	ASCIIString["AATGAGCGGTA"]
AATTATCCTCT	ASCIIString["ATTATCCTCTT"]
GAGTTGCAAGT	ASCIIString["AGTTGCAAGTG"]
GAAACTTAGTA	ASCIIString["AAACTTAGTAG"]
GGTCGCACATA	ASCIIString["GTCGCACATAA"]
TCATGCTCGAA	ASCIIString["CATGCTCGAAA"]
TCGCAATAACT	ASCIIString["CGCAATAACTG"]
AGGGTACTCCT	ASCIIString["GGGTACTCCTG"]
AAGCCACGGCT	ASCIIString["AGCCACGGCTG"]
AATATCAGCCT	ASCIIString["ATATCAGCCTA"]
ACTATAATCGT	ASCIIString["CTATAATCGTT"]
CAAGCTATCCG	ASCIIString["AAGCTATCCGG"]
AGTGTTCATGT	ASCIIString["GTGTTCATGTA"]
TGCCATTCCTC	ASCIIString["GCCATTCCTCC"]
AGAGTCTCCGT	ASCIIString["GAGTCTCCGTG"]
CTCCAGTTAGC	ASCIIString["TCCAGTTAGCC"]
TACCACTAATC	ASCIIString["ACCACTAATCG"]
TACGATTGAGT	ASCIIString["ACGATTGAGTC"]
TATGATGTGCG	ASCIIString["ATGATGTGCGG"]
ATAGAATTATC	ASCIIString["TAGAATTATCC"]
TCTGTTTTCGA	ASCIIString["CTGTTTTCGAA"]
GGACTCTGTGT	ASCIIString["GACTCTGTGTG"]
CCATATCAAGA	ASCIIString["CATATCAAGAT"]
AAACTTAGTAG	ASCIIString["AACTTAGTAGG"]
GGATACAGCTA	ASCIIString["GATACAGCTAA"]
TCCCCATCTGG	ASCIIString["CCCCATCTGGG"]
TAGACGTCCAT	ASCIIString["AGACGTCCATC"]
CGCAATAACTG	ASCIIString["GCAATAACTGA"]
AACGGGGCCCT	ASCIIString["ACGGGGCCCTC"]
CCCGCACCTTC	ASCIIString["CCGCACCTTCG"]
GTTTGCATGCC	ASCIIString["TTTGCATGCCA"]
TAACCGCTGGC	ASCIIString["AACCGCTGGCA"]
GTGCCCGCGCG	ASCIIString["TGCCCGCGCGA"]
GAATATCAGCC	ASCIIString["AATATCAGCCT"]
CCAGATAGACG	ASCIIString["CAGATAGACGT"]
GGACCTATTCG	ASCIIString["GACCTATTCGT"]
CATAGAAGAAT	ASCIIString["ATAGAAGAATG"]
AACACAGAACA	ASCIIString["ACACAGAACAG"]
GTATGCAGCTC	ASCIIString["TATGCAGCTCT"]
TACCTCTGCAC	ASCIIString["ACCTCTGCACG"]
GAAGAATGCTT	ASCIIString["AAGAATGCTTT"]
TGTGTGGCGAG	ASCIIString["GTGTGGCGAGC"]
AGATAGACGTC	ASCIIString["GATAGACGTCC"]
TAGGCCTATTA	ASCIIString["AGGCCTATTAC"]
CCCTAGACATG	ASCIIString["CCTAGACATGT"]
ACAGGTCACGG	ASCIIString["CAGGTCACGGC"]
TTGTTTGCATG	ASCIIString["TGTTTGCATGC"]
CACTATCAGTG	ASCIIString["ACTATCAGTGT"]
AGAACCGTTCC	ASCIIString["GAACCGTTCCT"]
TGTTGGTCTCA	ASCIIString["GTTGGTCTCAA"]
GCTGGCAGCTT	ASCIIString["CTGGCAGCTTG"]
CCATCTGGGTA	ASCIIString["CATCTGGGTAT"]
CCAGGTCAGGT	ASCIIString["CAGGTCAGGTG"]
GGCCTTCTCTG	ASCIIString["GCCTTCTCTGC"]
CCGAAGACGTA	ASCIIString["CGAAGACGTAC"]
GCTTGGGTTGG	ASCIIString["CTTGGGTTGGC"]
GAGAACCGTTC	ASCIIString["AGAACCGTTCC"]
AAGACGTACGG	ASCIIString["AGACGTACGGG"]
TTGGCAAGCTA	ASCIIString["TGGCAAGCTAT"]
GAGGTTAGCAC	ASCIIString["AGGTTAGCACG"]
GTGCTTATAAT	ASCIIString["TGCTTATAATT"]
CTATCAGTGTT	ASCIIString["TATCAGTGTTT"]
TAGGCAAACCT	ASCIIString["AGGCAAACCTA"]
CCCCTCATAGC	ASCIIString["CCCTCATAGCT"]
CATGCCATTCC	ASCIIString["ATGCCATTCCC"]
AATCGTTCAAT	ASCIIString["ATCGTTCAATG"]
CCTTTACTGGG	ASCIIString["CTTTACTGGGT"]
AGCTCCTTTCA	ASCIIString["GCTCCTTTCAA"]
CGAGCCATCAG	ASCIIString["GAGCCATCAGT"]
ACCTACTTCAC	ASCIIString["CCTACTTCACC"]
CATGTACTGTG	ASCIIString["ATGTACTGTGG"]
GCCACGGCTGC	ASCIIString["CCACGGCTGCC"]
TGTACGGAATA	ASCIIString["GTACGGAATAT","GTACGGAATAC"]
CTGAGCTATAA	ASCIIString["TGAGCTATAAC"]
CAAACCTACCT	ASCIIString["AAACCTACCTC"]
TGGAACGCTTA	ASCIIString["GGAACGCTTAT"]
AGAGATCCACG	ASCIIString["GAGATCCACGT"]
TCTAATTCGTG	ASCIIString["CTAATTCGTGC"]
AAGATTTAACC	ASCIIString["AGATTTAACCA"]
TCCATCGCAAT	ASCIIString["CCATCGCAATA"]
GGCACGATAGC	ASCIIString["GCACGATAGCC"]
TGGCGTACGGT	ASCIIString["GGCGTACGGTG"]
TGCTCGAAAAA	ASCIIString["GCTCGAAAAAC"]
GTTAGCGTAAC	ASCIIString["TTAGCGTAACT"]
CTTCTATGATT	ASCIIString["TTCTATGATTT"]
AACAAATTAAG	ASCIIString["ACAAATTAAGA"]
TCATGTACTGT	ASCIIString["CATGTACTGTG"]
CGCATGAAAAG	ASCIIString["GCATGAAAAGA"]
CGTTGAACCAG	ASCIIString["GTTGAACCAGT"]
CCACGACCGCG	ASCIIString["CACGACCGCGT"]
TTATGCCTAGG	ASCIIString["TATGCCTAGGC"]
CTCTGCACGCA	ASCIIString["TCTGCACGCAG"]
TAAGCCACGGC	ASCIIString["AAGCCACGGCT"]
CATCTCAAATG	ASCIIString["ATCTCAAATGC"]
CACCTACTTCA	ASCIIString["ACCTACTTCAC"]
TAATGGAACGC	ASCIIString["AATGGAACGCT"]
ATGTCAAGAAA	ASCIIString["TGTCAAGAAAT"]
CCCGCAGTACG	ASCIIString["CCGCAGTACGA"]
TGGCAATTAGT	ASCIIString["GGCAATTAGTT"]
GAGCCATCAGT	ASCIIString["AGCCATCAGTG"]
GTCCGGAGGGG	ASCIIString["TCCGGAGGGGC"]
CCTGGGGATGT	ASCIIString["CTGGGGATGTT"]
GGGTGCGTGAG	ASCIIString["GGTGCGTGAGG"]
ATACGTGCTTA	ASCIIString["TACGTGCTTAT"]
GGCAAACCTAC	ASCIIString["GCAAACCTACC"]
TGCCTAGGCAA	ASCIIString["GCCTAGGCAAC"]
TCCTCCCCTCA	ASCIIString["CCTCCCCTCAT"]
GATCAGGGTAC	ASCIIString["ATCAGGGTACT"]
CATCACCAAAC	ASCIIString["ATCACCAAACA"]
AACTACCACTA	ASCIIString["ACTACCACTAA"]
GCAGGTGCCAT	ASCIIString["CAGGTGCCATT"]
TTGAACCAGTG	ASCIIString["TGAACCAGTGG"]
AGTCGGACCTA	ASCIIString["GTCGGACCTAT"]
CTGAGAGAACC	ASCIIString["TGAGAGAACCG"]
TCAGGGTACTC	ASCIIString["CAGGGTACTCC"]
ACGGGGCCCTC	ASCIIString["CGGGGCCCTCC"]
ATTAGTTAGCG	ASCIIString["TTAGTTAGCGT"]
GTACGGTGACC	ASCIIString["TACGGTGACCA"]
CCATACGTGCT	ASCIIString["CATACGTGCTT"]
GAGATCCCACA	ASCIIString["AGATCCCACAG"]
GGATCTTCCTT	ASCIIString["GATCTTCCTTC"]
CTATTACGAAT	ASCIIString["TATTACGAATA"]
TGTCACGTGTC	ASCIIString["GTCACGTGTCC"]
TGGTCTCAATG	ASCIIString["GGTCTCAATGT"]
TCACCAAACAC	ASCIIString["CACCAAACACC"]
TGCCATAGTAG	ASCIIString["GCCATAGTAGG"]
CAAGAAATAAT	ASCIIString["AAGAAATAATA"]
AGTGTGCTTCC	ASCIIString["GTGTGCTTCCC"]
GTGGAAGGGGT	ASCIIString["TGGAAGGGGTG"]
ACTAAGCCACG	ASCIIString["CTAAGCCACGG"]
AACAGTGCGGG	ASCIIString["ACAGTGCGGGC"]
GCCTTCTCTGC	ASCIIString["CCTTCTCTGCA"]
ACACCGACGAG	ASCIIString["CACCGACGAGG"]
CGTTCAATGAG	ASCIIString["GTTCAATGAGC"]
CTAATTCGTGC	ASCIIString["TAATTCGTGCC"]
TAGAGGGGGTC	ASCIIString["AGAGGGGGTCG"]
CTAAGCCACGG	ASCIIString["TAAGCCACGGC"]
ACGTACGGGGG	ASCIIString["CGTACGGGGGA"]
GTCAAGCCAGA	ASCIIString["TCAAGCCAGAT"]
TCAGTGGAGCC	ASCIIString["CAGTGGAGCCA"]
ATTTAACCACT	ASCIIString["TTTAACCACTA"]
ACATTACGCAT	ASCIIString["CATTACGCATG"]
AATCGAAACAC	ASCIIString["ATCGAAACACC"]
TCCGTGCCCGC	ASCIIString["CCGTGCCCGCG"]
ATCAGTCAGTG	ASCIIString["TCAGTCAGTGG"]
TCACCGTTAAA	ASCIIString["CACCGTTAAAA"]
CAGTTCTGCGG	ASCIIString["AGTTCTGCGGA"]
AGGGGAAAAAG	ASCIIString["GGGGAAAAAGG"]
TTCCATCTGGA	ASCIIString["TCCATCTGGAT"]
TTAGCGTAACT	ASCIIString["TAGCGTAACTA"]
ACGGCCTTCTC	ASCIIString["CGGCCTTCTCT"]
TGTAGCAGGGA	ASCIIString["GTAGCAGGGAC"]
GCGGACCCGGC	ASCIIString["CGGACCCGGCA"]
AGATCCCACAG	ASCIIString["GATCCCACAGT"]
CTGGACTAAGC	ASCIIString["TGGACTAAGCC"]
TAGTTAGCGTA	ASCIIString["AGTTAGCGTAA"]
CAGAACAACAA	ASCIIString["AGAACAACAAG"]
AGGTGTATGCA	ASCIIString["GGTGTATGCAG"]
GCATAATGAGA	ASCIIString["CATAATGAGAG"]
GAAAAACATAT	ASCIIString["AAAAACATATA"]
CTTGGGTTGGC	ASCIIString["TTGGGTTGGCA"]
TGGTCCTCCTC	ASCIIString["GGTCCTCCTCT"]
TGCATAAGGCG	ASCIIString["GCATAAGGCGT"]
AGGTTAGCACG	ASCIIString["GGTTAGCACGA"]
CAATAACTGAG	ASCIIString["AATAACTGAGA"]
GAACAGTGCGG	ASCIIString["AACAGTGCGGG"]
TCTTCCTTCTT	ASCIIString["CTTCCTTCTTT"]
TTCTAGGCCTA	ASCIIString["TCTAGGCCTAT"]
CTCAAATGCGC	ASCIIString["TCAAATGCGCA"]
CTCTGCATAAG	ASCIIString["TCTGCATAAGG"]
CTGTCTGTTTT	ASCIIString["TGTCTGTTTTC"]
AGGTCACGGCT	ASCIIString["GGTCACGGCTA"]
GTGACCAAATA	ASCIIString["TGACCAAATAA"]
CTTCCCGCAGT	ASCIIString["TTCCCGCAGTA"]
TAGTAGAGGGG	ASCIIString["AGTAGAGGGGG"]
GGGCCCTCCCA	ASCIIString["GGCCCTCCCAA"]
CACATAAGTAT	ASCIIString["ACATAAGTATT"]
AGCAGCTGGAT	ASCIIString["GCAGCTGGATC"]
ATGGTCCTCCT	ASCIIString["TGGTCCTCCTC"]
TAACCTGCGGT	ASCIIString["AACCTGCGGTA"]
ACGTGTCCGGA	ASCIIString["CGTGTCCGGAG"]
AAGGCCTTCAA	ASCIIString["AGGCCTTCAAA"]
TCGAAACACCT	ASCIIString["CGAAACACCTA"]
TCTATCACAGT	ASCIIString["CTATCACAGTT"]
AAAGGTCAGGA	ASCIIString["AAGGTCAGGAA"]
CTCTTGTACCA	ASCIIString["TCTTGTACCAA"]
CTATTAGGAGG	ASCIIString["TATTAGGAGGA"]
TTGCGGGTAAT	ASCIIString["TGCGGGTAATC"]
TAGGCAACGGA	ASCIIString["AGGCAACGGAG"]
AAGGCAGAACA	ASCIIString["AGGCAGAACAA"]
TTGGGTTGGCA	ASCIIString["TGGGTTGGCAA"]
TGCGAAAGGTC	ASCIIString["GCGAAAGGTCA"]
GCAGCTTGACA	ASCIIString["CAGCTTGACAG"]
GTGCGCCAAGG	ASCIIString["TGCGCCAAGGG"]
CTAGGCCTATT	ASCIIString["TAGGCCTATTA"]
GAGTCGGACCT	ASCIIString["AGTCGGACCTA"]
CATAATGGAAC	ASCIIString["ATAATGGAACG"]
TAGAGCCACTG	ASCIIString["AGAGCCACTGC"]
GAGAGAGGTTA	ASCIIString["AGAGAGGTTAG"]
CCTGGACTAAG	ASCIIString["CTGGACTAAGC"]
CCACGGCTGCC	ASCIIString["CACGGCTGCCA"]
TATAACCGCTG	ASCIIString["ATAACCGCTGG"]
CATCTGGATCT	ASCIIString["ATCTGGATCTT"]
GAGGAGGTCGG	ASCIIString["AGGAGGTCGGA"]
CTAGTGAATCG	ASCIIString["TAGTGAATCGA"]
TGGAAGGCCTT	ASCIIString["GGAAGGCCTTC"]
AGCTAGTGCGA	ASCIIString["GCTAGTGCGAA"]
CATAATGAGAG	ASCIIString["ATAATGAGAGG"]
CGTGAGGTCCC	ASCIIString["GTGAGGTCCCA"]
TTACGCATGAA	ASCIIString["TACGCATGAAA"]
TTTCTCTCCAT	ASCIIString["TTCTCTCCATC"]
GTAGGTTTCTA	ASCIIString["TAGGTTTCTAG"]
TAGCAGGGACC	ASCIIString["AGCAGGGACCC"]
GTTAACCTGCG	ASCIIString["TTAACCTGCGG"]
TTCCCTTTACT	ASCIIString["TCCCTTTACTG"]
GCTATTAGGAG	ASCIIString["CTATTAGGAGG"]
CATAGTAGGTT	ASCIIString["ATAGTAGGTTT"]
CCCAACTTCAT	ASCIIString["CCAACTTCATG"]
CAGAAGCTAGT	ASCIIString["AGAAGCTAGTG"]
TGTTTCCATCT	ASCIIString["GTTTCCATCTG"]
TAAACAGGCAC	ASCIIString["AAACAGGCACG"]
TTCTTATCAGT	ASCIIString["TCTTATCAGTC"]
AGTAGGCAAAC	ASCIIString["GTAGGCAAACC"]
GGTGGAAGGGG	ASCIIString["GTGGAAGGGGT"]
GTACCCACATC	ASCIIString["TACCCACATCT"]
GTACGATTGAG	ASCIIString["TACGATTGAGT"]
ATAAGGCGTGG	ASCIIString["TAAGGCGTGGC"]
CAGTGACGCGA	ASCIIString["AGTGACGCGAA"]
TTAGTTAGCGT	ASCIIString["TAGTTAGCGTA"]
GTAGCAGGGAC	ASCIIString["TAGCAGGGACC"]
CCAAGGGAGTC	ASCIIString["CAAGGGAGTCG"]
TGAGCGAGGAG	ASCIIString["GAGCGAGGAGT"]
TATGCCTAGGC	ASCIIString["ATGCCTAGGCA"]
TCGCACATAAT	ASCIIString["CGCACATAATG"]
TACTATATGGA	ASCIIString["ACTATATGGAT"]
TTTGTGCGCCA	ASCIIString["TTGTGCGCCAA"]
GTGTTGGTCTC	ASCIIString["TGTTGGTCTCA"]
GTACGGGGGAG	ASCIIString["TACGGGGGAGA"]
GTAGGCAAGAG	ASCIIString["TAGGCAAGAGT"]
CAGTTAGCCAA	ASCIIString["AGTTAGCCAAC"]
AAGAGTCTCCG	ASCIIString["AGAGTCTCCGT"]
TCTCTGCATAA	ASCIIString["CTCTGCATAAG"]
GGACCCGGCAC	ASCIIString["GACCCGGCACA"]
CGAAGGCTAAG	ASCIIString["GAAGGCTAAGC"]
AACAGTGACGC	ASCIIString["ACAGTGACGCG"]
GAGATGTAGCA	ASCIIString["AGATGTAGCAA"]
TGCGGACCTGG	ASCIIString["GCGGACCTGGA"]
TGCTGCGGACC	ASCIIString["GCTGCGGACCC"]
GAGCCCCATTC	ASCIIString["AGCCCCATTCT"]
CCGCTTGGGTT	ASCIIString["CGCTTGGGTTG"]
TAGCGTAACTA	ASCIIString["AGCGTAACTAC"]
GTACTCCTGTG	ASCIIString["TACTCCTGTGC"]
CAAAACAGTGA	ASCIIString["AAAACAGTGAC"]
TCTACACGTGT	ASCIIString["CTACACGTGTC"]
CGTTGCCTGGT	ASCIIString["GTTGCCTGGTA"]
CGGCTCAAACA	ASCIIString["GGCTCAAACAT"]
GTATCGTTAAG	ASCIIString["TATCGTTAAGG"]
CCATTCCTCCC	ASCIIString["CATTCCTCCCC"]
TCCTTCACAGG	ASCIIString["CCTTCACAGGT"]
AGTATTGAGGT	ASCIIString["GTATTGAGGTG"]
TACGCATGAAA	ASCIIString["ACGCATGAAAA"]
TACAGTACCTA	ASCIIString["ACAGTACCTAA"]
CCATCAGTGAA	ASCIIString["CATCAGTGAAA"]
GTTCCATATCA	ASCIIString["TTCCATATCAA"]
AGGTCATGTAC	ASCIIString["GGTCATGTACT"]
TTCATGTATAC	ASCIIString["TCATGTATACG"]
TGGTAGCGATT	ASCIIString["GGTAGCGATTT"]
GAGGCGATACA	ASCIIString["AGGCGATACAT"]
TTGTCAAGCCA	ASCIIString["TGTCAAGCCAG"]
TGTTATAAGAG	ASCIIString["GTTATAAGAGG"]
TGGATGAAAAC	ASCIIString["GGATGAAAACA"]
GGATGAAAACA	ASCIIString["GATGAAAACAA"]
ACTACCACTAA	ASCIIString["CTACCACTAAT"]
TATTCGTTGAA	ASCIIString["ATTCGTTGAAC"]
AGTTAACTCGT	ASCIIString["GTTAACTCGTG"]
ACAAAACAGTG	ASCIIString["CAAAACAGTGA"]
AAACACCTACT	ASCIIString["AACACCTACTT"]
TTAGCACGACT	ASCIIString["TAGCACGACTT"]
GGCCGAAGACG	ASCIIString["GCCGAAGACGT"]
AGGAATAGGGA	ASCIIString["GGAATAGGGAG"]
TTCCTCGATAA	ASCIIString["TCCTCGATAAC"]
TACCCAAGTTG	ASCIIString["ACCCAAGTTGT"]
GTAGCGATTTC	ASCIIString["TAGCGATTTCT"]
GTTTCTAGGCC	ASCIIString["TTTCTAGGCCT"]
TTTATAAATCC	ASCIIString["TTATAAATCCA"]
GTAGAGGGGGT	ASCIIString["TAGAGGGGGTC"]
ACTGAGAGAAC	ASCIIString["CTGAGAGAACC"]
AAACTATAATC	ASCIIString["AACTATAATCG"]
TCGTGCCTGTT	ASCIIString["CGTGCCTGTTA"]
CTAATCGATTG	ASCIIString["TAATCGATTGG"]
ACCAAATAACC	ASCIIString["CCAAATAACCC"]
ATTACCCAAGT	ASCIIString["TTACCCAAGTT"]
GCATAGAAGAA	ASCIIString["CATAGAAGAAT"]
CTGGTGTACGG	ASCIIString["TGGTGTACGGA"]
ATCAAGATTTA	ASCIIString["TCAAGATTTAA"]
CAAACATTACG	ASCIIString["AAACATTACGC"]
CCGCAGTACGA	ASCIIString["CGCAGTACGAT"]
CAGCGGTGGAT	ASCIIString["AGCGGTGGATA"]
CCTTCTCTGCA	ASCIIString["CTTCTCTGCAT"]
TAGAATTATCC	ASCIIString["AGAATTATCCT"]
TCTTGTACCAA	ASCIIString["CTTGTACCAAG"]
GTCCATCCTTT	ASCIIString["TCCATCCTTTG"]
TGTAGCAACAC	ASCIIString["GTAGCAACACA"]
CCTTCTTTGCC	ASCIIString["CTTCTTTGCCT"]
TTAACTCGTGT	ASCIIString["TAACTCGTGTC"]
GTGCCATTCCT	ASCIIString["TGCCATTCCTC"]
ATCACAGTTAA	ASCIIString["TCACAGTTAAC"]
GAGCTATAACG	ASCIIString["AGCTATAACGA"]
AAAGAGGATAC	ASCIIString["AAGAGGATACA"]
GGAACCTCCCT	ASCIIString["GAACCTCCCTC"]
GCGGTGGATAC	ASCIIString["CGGTGGATACA"]
TCAGGTGAGCG	ASCIIString["CAGGTGAGCGA"]
CTAAATCTGGA	ASCIIString["TAAATCTGGAA"]
GCACGCAGTTC	ASCIIString["CACGCAGTTCT"]
CGGAATACTAT	ASCIIString["GGAATACTATA"]
AAGGGATACAG	ASCIIString["AGGGATACAGT"]
CTTCTCTGCAT	ASCIIString["TTCTCTGCATA"]
TCGAGAGAAAA	ASCIIString["CGAGAGAAAAG"]
TAAGCTGGCGA	ASCIIString["AAGCTGGCGAG"]
GTTTAATATAG	ASCIIString["TTTAATATAGA"]
GGGTCGGAGTC	ASCIIString["GGTCGGAGTCG"]
ATCTTCCTTCT	ASCIIString["TCTTCCTTCTT"]
TTCATCCCCCC	ASCIIString["TCATCCCCCCC"]
AGTTCAGCAGC	ASCIIString["GTTCAGCAGCT"]
GCAACACAGAA	ASCIIString["CAACACAGAAC"]
TATGGTCCTCC	ASCIIString["ATGGTCCTCCT"]
TGCCATTCCCT	ASCIIString["GCCATTCCCTT"]
CTACTACCCGT	ASCIIString["TACTACCCGTA"]
GACCAAATAAC	ASCIIString["ACCAAATAACC"]
CGAAAGGTCAG	ASCIIString["GAAAGGTCAGG"]
AGATCCACGTG	ASCIIString["GATCCACGTGG"]
TTATAATTGTC	ASCIIString["TATAATTGTCA"]
CGGTAGTAGAG	ASCIIString["GGTAGTAGAGG"]
TGCCCGCGCGA	ASCIIString["GCCCGCGCGAG"]
CTAGTCCTATG	ASCIIString["TAGTCCTATGT"]
TTCGTTGAACC	ASCIIString["TCGTTGAACCA"]
CTCCCCTCATA	ASCIIString["TCCCCTCATAG"]
ACAAGGTACGA	ASCIIString["CAAGGTACGAA"]
ATTCGTTGAAC	ASCIIString["TTCGTTGAACC"]
CACGGCTGCCA	ASCIIString["ACGGCTGCCAT"]
TTGTACCAAGC	ASCIIString["TGTACCAAGCG"]
CGAACAATTGT	ASCIIString["GAACAATTGTC"]
TCAAGAAATAA	ASCIIString["CAAGAAATAAT"]
GAGGGGCCCGC	ASCIIString["AGGGGCCCGCA"]
AAACATTACGC	ASCIIString["AACATTACGCA"]
CATTACGCATG	ASCIIString["ATTACGCATGA"]
GGTGGCGTACG	ASCIIString["GTGGCGTACGG"]
ACCACTAAGTT	ASCIIString["CCACTAAGTTG"]
CGCTTGGGTTG	ASCIIString["GCTTGGGTTGG"]
CCCACAGTTCC	ASCIIString["CCACAGTTCCT"]
GGTCACGGCTA	ASCIIString["GTCACGGCTAC"]
GGCCATCCTAC	ASCIIString["GCCATCCTACT"]
TGCTTATAATT	ASCIIString["GCTTATAATTG"]
GACTCATTGGA	ASCIIString["ACTCATTGGAA"]
ATATCAGCCTA	ASCIIString["TATCAGCCTAG"]
TGCATAGAAGA	ASCIIString["GCATAGAAGAA"]
TTCGATTACCC	ASCIIString["TCGATTACCCA"]
GAGCGTCGAGA	ASCIIString["AGCGTCGAGAG"]
GTACTGTGGGT	ASCIIString["TACTGTGGGTG"]
GTGTCCGGAGG	ASCIIString["TGTCCGGAGGG"]
CTAGTGCGAAA	ASCIIString["TAGTGCGAAAG"]
CGCGAGAGTTG	ASCIIString["GCGAGAGTTGC"]
ACAATTGTCCC	ASCIIString["CAATTGTCCCG"]
TCAGGAATAGG	ASCIIString["CAGGAATAGGG"]
ACGCAGCACGC	ASCIIString["CGCAGCACGCA"]
ATCTGGAAGGC	ASCIIString["TCTGGAAGGCC"]
GCACGCAGCAC	ASCIIString["CACGCAGCACG"]
AGGCGCCTGGG	ASCIIString["GGCGCCTGGGG"]
GGTTGGCAAGC	ASCIIString["GTTGGCAAGCT"]
CGACTCATTGG	ASCIIString["GACTCATTGGA"]
GATCGGCATAA	ASCIIString["ATCGGCATAAT"]
AGCTTGACAGA	ASCIIString["GCTTGACAGAT"]
AAGCTGGCGAG	ASCIIString["AGCTGGCGAGC"]
ACAGTGACGCG	ASCIIString["CAGTGACGCGA"]
CCCATCTGGGT	ASCIIString["CCATCTGGGTA"]
ATAATCGTTCA	ASCIIString["TAATCGTTCAA"]
GCCTGGGGATG	ASCIIString["CCTGGGGATGT"]
GAGGGAGGAGG	ASCIIString["AGGGAGGAGGT"]
CTCGTGTCCAT	ASCIIString["TCGTGTCCATA"]
ATAGGTGGAAG	ASCIIString["TAGGTGGAAGG"]
GATTACCCAAG	ASCIIString["ATTACCCAAGT"]
ACTGGTGTACG	ASCIIString["CTGGTGTACGG"]
GATCCCACAGT	ASCIIString["ATCCCACAGTT"]
CGGTAGCGTGG	ASCIIString["GGTAGCGTGGT"]
AGGGAGTCGGA	ASCIIString["GGGAGTCGGAC"]
ATCCTTTGAAG	ASCIIString["TCCTTTGAAGT"]
CCTCCAGTTAG	ASCIIString["CTCCAGTTAGC"]
TGAAACTTAGT	ASCIIString["GAAACTTAGTA"]
CGTGCCCGCGC	ASCIIString["GTGCCCGCGCG"]
GGAAAAAGGGA	ASCIIString["GAAAAAGGGAT"]
GTGGGTGCTGT	ASCIIString["TGGGTGCTGTG"]
CCCGGCACACA	ASCIIString["CCGGCACACAT"]
TTCTCTCCATC	ASCIIString["TCTCTCCATCG"]
TGCGGTAGCGT	ASCIIString["GCGGTAGCGTG"]
TGCTTTCGTAA	ASCIIString["GCTTTCGTAAG"]
ATACGGCCTTC	ASCIIString["TACGGCCTTCT"]
CCGCACCTTCG	ASCIIString["CGCACCTTCGA"]
AAAGGGATACA	ASCIIString["AAGGGATACAG"]
TGCAAAAACTT	ASCIIString["GCAAAAACTTT"]
TGCCTGTTAAC	ASCIIString["GCCTGTTAACC"]
GAGAGAAAAGA	ASCIIString["AGAGAAAAGAG"]
GGCTACGACTC	ASCIIString["GCTACGACTCA"]
TACGGAATACT	ASCIIString["ACGGAATACTA"]
GAGTCTCCGTG	ASCIIString["AGTCTCCGTGC"]
ACTACCCGTAT	ASCIIString["CTACCCGTATC"]
TAACCACTAAG	ASCIIString["AACCACTAAGT"]
TTCACAGGTCA	ASCIIString["TCACAGGTCAC"]
AGCGGTGGATA	ASCIIString["GCGGTGGATAC"]
AATTAAGAGCG	ASCIIString["ATTAAGAGCGT"]
CTAAACAGGCA	ASCIIString["TAAACAGGCAC"]
ACGGCTACGAC	ASCIIString["CGGCTACGACT"]
AAACAAAACAG	ASCIIString["AACAAAACAGT"]
ATTCCTCCCCT	ASCIIString["TTCCTCCCCTC"]
CACGACCGCGT	ASCIIString["ACGACCGCGTA"]
GATGGCAATTA	ASCIIString["ATGGCAATTAG"]
CAAATAACCCA	ASCIIString["AAATAACCCAC"]
CAGCACGCAGT	ASCIIString["AGCACGCAGTT"]
CTCTTTGTGCG	ASCIIString["TCTTTGTGCGC"]
ATTTGAGGTGT	ASCIIString["TTTGAGGTGTA"]
TAACTACCACT	ASCIIString["AACTACCACTA"]
CACAGTTCCTT	ASCIIString["ACAGTTCCTTC"]
GTTGTTCCATA	ASCIIString["TTGTTCCATAT"]
ATTGTCCCGGT	ASCIIString["TTGTCCCGGTA"]
TTAAGGACTCT	ASCIIString["TAAGGACTCTG"]
TACGTGCTTAT	ASCIIString["ACGTGCTTATA"]
CTCATTGGAAC	ASCIIString["TCATTGGAACC"]
ATGCCATTCCC	ASCIIString["TGCCATTCCCT"]
GCCTAGTCCTA	ASCIIString["CCTAGTCCTAT"]
CATGCTCGAAA	ASCIIString["ATGCTCGAAAA"]
AAAAAGGGATA	ASCIIString["AAAAGGGATAC"]
GAGAGTTGCAA	ASCIIString["AGAGTTGCAAG"]
CCAAGCGTTTA	ASCIIString["CAAGCGTTTAA"]
AGCCAGATAGA	ASCIIString["GCCAGATAGAC"]
ATCCAGCAGCA	ASCIIString["TCCAGCAGCAG"]
AGCTAAATCTG	ASCIIString["GCTAAATCTGG"]
GGCGCCTGGGG	ASCIIString["GCGCCTGGGGA"]
CACGTGGAAAG	ASCIIString["ACGTGGAAAGT"]
TAGGAGGATGT	ASCIIString["AGGAGGATGTA"]
GGCCTTCAAAA	ASCIIString["GCCTTCAAAAC"]
AATATAGAGCC	ASCIIString["ATATAGAGCCA"]
TAAGGACTCTG	ASCIIString["AAGGACTCTGT"]
TGGGGATGTTC	ASCIIString["GGGGATGTTCA"]
CGTGTCCGGAG	ASCIIString["GTGTCCGGAGG"]
GGGAGGAGTGT	ASCIIString["GGAGGAGTGTG"]
ATGAGCGGTAG	ASCIIString["TGAGCGGTAGT"]
TCAACCGCTTG	ASCIIString["CAACCGCTTGG"]
CATGATGGTCT	ASCIIString["ATGATGGTCTA"]
CGCCAAGGGAG	ASCIIString["GCCAAGGGAGT"]
GTTGTAGGCAA	ASCIIString["TTGTAGGCAAG"]
ATGCCTAGGCA	ASCIIString["TGCCTAGGCAA"]
GTGTATGCAGC	ASCIIString["TGTATGCAGCT"]
GATCTTCCTTC	ASCIIString["ATCTTCCTTCT"]
CCCAGTCTGAG	ASCIIString["CCAGTCTGAGC"]
ATCCTCTTGTA	ASCIIString["TCCTCTTGTAC"]
AGGGACCCAGT	ASCIIString["GGGACCCAGTC"]
AGGTGGAAGGG	ASCIIString["GGTGGAAGGGG"]
CAGGTGCCATT	ASCIIString["AGGTGCCATTC"]
CTATAACGATG	ASCIIString["TATAACGATGA"]
CTGGGTATAGA	ASCIIString["TGGGTATAGAA"]
ATCCTACTACC	ASCIIString["TCCTACTACCC"]
CGGCTGCCATA	ASCIIString["GGCTGCCATAG"]
GTGCGGTCGCA	ASCIIString["TGCGGTCGCAC"]
CCCAAGTTGTT	ASCIIString["CCAAGTTGTTT"]
CCCCTAGACAT	ASCIIString["CCCTAGACATG"]
TAAATCCAGCA	ASCIIString["AAATCCAGCAG"]
GCAATTAGTTA	ASCIIString["CAATTAGTTAG"]
ATCGGGGCAAC	ASCIIString["TCGGGGCAACA"]
ACGGAATACTA	ASCIIString["CGGAATACTAT"]
CAAGATTTAAC	ASCIIString["AAGATTTAACC"]
GCCCCATTCTT	ASCIIString["CCCCATTCTTG"]
TCAGTCAGTGG	ASCIIString["CAGTCAGTGGA"]
AAATCCAGCAG	ASCIIString["AATCCAGCAGC"]
TTGAGTCCCCA	ASCIIString["TGAGTCCCCAT"]
CCATTCCCTTT	ASCIIString["CATTCCCTTTA"]
GGTCGGAGATC	ASCIIString["GTCGGAGATCC"]
GGGGAGAGGCC	ASCIIString["GGGAGAGGCCA"]
GCGGGCAGGGG	ASCIIString["CGGGCAGGGGA"]
ACTAAGTTGCG	ASCIIString["CTAAGTTGCGG"]
CCACTGCAAAA	ASCIIString["CACTGCAAAAA"]
TTGCCTTCTAT	ASCIIString["TGCCTTCTATG"]
GTCTCCGTGCC	ASCIIString["TCTCCGTGCCC"]
AAAGAGATCCA	ASCIIString["AAGAGATCCAC"]
GAGTCGGCCAT	ASCIIString["AGTCGGCCATA"]
CCGCGTACCCA	ASCIIString["CGCGTACCCAC"]
ATCCACGTGGA	ASCIIString["TCCACGTGGAA"]
CGCAGGTGCCA	ASCIIString["GCAGGTGCCAT"]
CCTATTCGTTG	ASCIIString["CTATTCGTTGA"]
GGAGCTCCTTT	ASCIIString["GAGCTCCTTTC"]
TCCCCCCCCTA	ASCIIString["CCCCCCCCTAG"]
CAGATAGACGT	ASCIIString["AGATAGACGTC"]
TCGTTAAGGAC	ASCIIString["CGTTAAGGACT"]
GAGGTGGCGTA	ASCIIString["AGGTGGCGTAC"]
CAAGTGTTCAT	ASCIIString["AAGTGTTCATG"]
CACCTTCGATT	ASCIIString["ACCTTCGATTA"]
TCCTCTGTCTG	ASCIIString["CCTCTGTCTGT"]
CGATTTCTTAT	ASCIIString["GATTTCTTATC"]
CCAGCAGCAGC	ASCIIString["CAGCAGCAGCG"]
CTGGTAGCGAT	ASCIIString["TGGTAGCGATC"]
TATAAGAGGGA	ASCIIString["ATAAGAGGGAG"]
GTGTCTCAGCC	ASCIIString["TGTCTCAGCCA"]
AATGTTGCTGC	ASCIIString["ATGTTGCTGCG"]
CGGACCTATTC	ASCIIString["GGACCTATTCG"]
GCGCAGGTGCC	ASCIIString["CGCAGGTGCCA"]
GAGGCGCCTGG	ASCIIString["AGGCGCCTGGG"]
GATAACTGGTG	ASCIIString["ATAACTGGTGT"]
CCATAGGTGGA	ASCIIString["CATAGGTGGAA"]
TGCACGCAGCA	ASCIIString["GCACGCAGCAC"]
GGGGCCCGCAC	ASCIIString["GGGCCCGCACC"]
CCCTCATAGCT	ASCIIString["CCTCATAGCTA"]
ACCCAAGTTGT	ASCIIString["CCCAAGTTGTT"]
ATAATGGAACG	ASCIIString["TAATGGAACGC"]
ATGCGCAGGTG	ASCIIString["TGCGCAGGTGC"]
CTTCAAAACAA	ASCIIString["TTCAAAACAAA"]
TGAGCTATAAC	ASCIIString["GAGCTATAACG"]
GTTCCTCGATA	ASCIIString["TTCCTCGATAA"]
GATTTAACCAC	ASCIIString["ATTTAACCACT"]
TATTGAGGTGG	ASCIIString["ATTGAGGTGGC"]
CCACAGTTCCT	ASCIIString["CACAGTTCCTT"]
GGGAGTCGGAC	ASCIIString["GGAGTCGGACC"]
ATATGGATGGC	ASCIIString["TATGGATGGCA"]
ACTAATCGATT	ASCIIString["CTAATCGATTG"]
TCAGTGAAACT	ASCIIString["CAGTGAAACTT"]
GTCACGGCTAC	ASCIIString["TCACGGCTACG"]
TCCATATCAAG	ASCIIString["CCATATCAAGA"]
CCCTCCCAACT	ASCIIString["CCTCCCAACTT"]
AACAACAAGCA	ASCIIString["ACAACAAGCAG"]
GTCATGTACTG	ASCIIString["TCATGTACTGT"]
GAACCTCCCTC	ASCIIString["AACCTCCCTCC"]
TTTCATGCTCG	ASCIIString["TTCATGCTCGA"]
CACAGAACAGT	ASCIIString["ACAGAACAGTG"]
GCGTTTAATAT	ASCIIString["CGTTTAATATA"]
AGTCCTATGTT	ASCIIString["GTCCTATGTTT"]
GCGTGAGGTCC	ASCIIString["CGTGAGGTCCC"]
TAATTCGTGCC	ASCIIString["AATTCGTGCCT"]
TGGGTGCGTGA	ASCIIString["GGGTGCGTGAG"]
AACATATATAA	ASCIIString["ACATATATAAC"]
CGCTTATGCCT	ASCIIString["GCTTATGCCTA"]
CCAGAAGCTAG	ASCIIString["CAGAAGCTAGT"]
GACGGCCGAAG	ASCIIString["ACGGCCGAAGA"]
ATCGTTAAGGA	ASCIIString["TCGTTAAGGAC"]
ATCTGGATCTT	ASCIIString["TCTGGATCTTC"]
GTTTTCGAAAG	ASCIIString["TTTTCGAAAGG"]
CCAGTTAGCCA	ASCIIString["CAGTTAGCCAA"]
GCAGGGGAAAA	ASCIIString["CAGGGGAAAAA"]
CTGGAAGGCCT	ASCIIString["TGGAAGGCCTT"]
CCAAACACCGA	ASCIIString["CAAACACCGAC"]
TATTACGAATA	ASCIIString["ATTACGAATAC"]
CTGCCATAGTA	ASCIIString["TGCCATAGTAG"]
ACTTGCGGCGG	ASCIIString["CTTGCGGCGGA"]
AAATCTGGAAG	ASCIIString["AATCTGGAAGG"]
AATACTATATG	ASCIIString["ATACTATATGG"]
CTCCTTTCAAC	ASCIIString["TCCTTTCAACC"]
GGGAAAAAGGG	ASCIIString["GGAAAAAGGGA"]
GCCCGCACCTT	ASCIIString["CCCGCACCTTC"]
GGTGTTGGTCT	ASCIIString["GTGTTGGTCTC"]
GAGCTCCTTTC	ASCIIString["AGCTCCTTTCA"]
TCGTAAGACGA	ASCIIString["CGTAAGACGAT"]
AGATGTAGCAA	ASCIIString["GATGTAGCAAC"]
AAGGACTCTGT	ASCIIString["AGGACTCTGTG"]
GGAGGGGCCCG	ASCIIString["GAGGGGCCCGC"]
GAATGCTTTCG	ASCIIString["AATGCTTTCGT"]
CGGCCTTCTCT	ASCIIString["GGCCTTCTCTG"]
CTCTGTCTGTT	ASCIIString["TCTGTCTGTTT"]
CATAGGTGGAA	ASCIIString["ATAGGTGGAAG"]
TATAACGATGA	ASCIIString["ATAACGATGAT"]
GCAAAAACTTT	ASCIIString["CAAAAACTTTT"]
AGGGGCCCGCA	ASCIIString["GGGGCCCGCAC"]
GAATAGGGAGG	ASCIIString["AATAGGGAGGA"]
AGGAGGTCGGA	ASCIIString["GGAGGTCGGAG"]
GTCCTCCTCTG	ASCIIString["TCCTCCTCTGT"]
GGCGAGCCATC	ASCIIString["GCGAGCCATCA"]
TTCACCGTTAA	ASCIIString["TCACCGTTAAA"]
TCAAGCCAGAT	ASCIIString["CAAGCCAGATC"]
ATTGGAGGTTC	ASCIIString["TTGGAGGTTCT"]
TTTAATATAGA	ASCIIString["TTAATATAGAG"]
CAAATTAAGAG	ASCIIString["AAATTAAGAGC"]
TGAGTCCCCAT	ASCIIString["GAGTCCCCATC"]
AGTTGCGGGTA	ASCIIString["GTTGCGGGTAA"]
CACACGTTGCC	ASCIIString["ACACGTTGCCT"]
CCCAGGTCAGG	ASCIIString["CCAGGTCAGGT"]
TGATATGTCAC	ASCIIString["GATATGTCACG"]
AACTTCATGTT	ASCIIString["ACTTCATGTTA"]
TCCGGAGGGGC	ASCIIString["CCGGAGGGGCC"]
GCTAAGCTGGC	ASCIIString["CTAAGCTGGCG"]
AAGAATGCTTT	ASCIIString["AGAATGCTTTC"]
ACGACCGCGTA	ASCIIString["CGACCGCGTAC"]
CAACTTCATGT	ASCIIString["AACTTCATGTT"]
CCCCCCCTAGA	ASCIIString["CCCCCCTAGAC"]
TCTAGGCCTAT	ASCIIString["CTAGGCCTATT"]
GGCCTATTACG	ASCIIString["GCCTATTACGA"]
AAAACTTTTCT	ASCIIString["AAACTTTTCTC"]
CGTGGTTGTAG	ASCIIString["GTGGTTGTAGG"]
CCGGTACCTCT	ASCIIString["CGGTACCTCTG"]
AGTGAATCGAA	ASCIIString["GTGAATCGAAA"]
GAACCAGTGGA	ASCIIString["AACCAGTGGAT"]
AGAGGGGGTCG	ASCIIString["GAGGGGGTCGG"]
CCAGTCTGAGC	ASCIIString["CAGTCTGAGCT"]
ACCAAGCGTTT	ASCIIString["CCAAGCGTTTA"]
GGCAACAAGGT	ASCIIString["GCAACAAGGTA"]
ATGCAGCTCTA	ASCIIString["TGCAGCTCTAA"]
AGCGTGGTTGT	ASCIIString["GCGTGGTTGTA"]
AGAGGCGCCTG	ASCIIString["GAGGCGCCTGG"]
TGTGGGTGCTG	ASCIIString["GTGGGTGCTGT"]
TGGGTGCTGTG	ASCIIString["GGGTGCTGTGT"]
TCATAGCTATT	ASCIIString["CATAGCTATTA"]
ATTAGGAGGAT	ASCIIString["TTAGGAGGATG"]
AAGTTGTTTGC	ASCIIString["AGTTGTTTGCA"]
GTTAACTCGTG	ASCIIString["TTAACTCGTGT"]
ACGTATGGTCC	ASCIIString["CGTATGGTCCT"]
ATGGTCTACAC	ASCIIString["TGGTCTACACG"]
GTGTCCATAGG	ASCIIString["TGTCCATAGGT"]
GCAAGCTATCC	ASCIIString["CAAGCTATCCG"]
CCCTCCAGTTA	ASCIIString["CCTCCAGTTAG"]
AAAAACATATA	ASCIIString["AAAACATATAT"]
CTGCGGTAGCG	ASCIIString["TGCGGTAGCGT"]
GAAGGCCTTCA	ASCIIString["AAGGCCTTCAA"]
CGTTAAGGACT	ASCIIString["GTTAAGGACTC"]
TGCGGGTAATC	ASCIIString["GCGGGTAATCG"]
ACGATAGCCCC	ASCIIString["CGATAGCCCCA"]
ATACAGTTGGT	ASCIIString["TACAGTTGGTA"]
TCGTGTCCATA	ASCIIString["CGTGTCCATAG"]
CCTCTTGTACC	ASCIIString["CTCTTGTACCA"]
GCCACTGCAAA	ASCIIString["CCACTGCAAAA"]
TCTGCATAAGG	ASCIIString["CTGCATAAGGC"]
AGGCGTGGCGG	ASCIIString["GGCGTGGCGGT"]
AGCACGCAGTT	ASCIIString["GCACGCAGTTC"]
ATTACGAATAC	ASCIIString["TTACGAATACG"]
ATTCCCTTTAC	ASCIIString["TTCCCTTTACT"]
CGGTTTATAAA	ASCIIString["GGTTTATAAAT"]
TGTTCATCCCC	ASCIIString["GTTCATCCCCC"]
TTCTTGGTCAC	ASCIIString["TCTTGGTCACA"]
GCCCCAGGTCA	ASCIIString["CCCCAGGTCAG"]
TGGAGCCAGAT	ASCIIString["GGAGCCAGATA"]
CTGGATCATGG	ASCIIString["TGGATCATGGT"]
GGTGCCATTCC	ASCIIString["GTGCCATTCCT"]
TTCAATGAGCG	ASCIIString["TCAATGAGCGG"]
CCCGGTACCTC	ASCIIString["CCGGTACCTCT"]
CTGGGTGCGTG	ASCIIString["TGGGTGCGTGA"]
GAGCCACTGCA	ASCIIString["AGCCACTGCAA"]
GAGCGAGGAGT	ASCIIString["AGCGAGGAGTT"]
GACTCTGTGTG	ASCIIString["ACTCTGTGTGG"]
AGTGGAGCCAG	ASCIIString["GTGGAGCCAGA"]
GTGGCGAGCCA	ASCIIString["TGGCGAGCCAT"]
TATAATCGTTC	ASCIIString["ATAATCGTTCA"]
CTGCATAAGGC	ASCIIString["TGCATAAGGCG"]
TACTTCACCGT	ASCIIString["ACTTCACCGTT"]
GTAGCGATCAG	ASCIIString["TAGCGATCAGG"]
ATGTCACGTGT	ASCIIString["TGTCACGTGTC"]
ATAGTAGGTTT	ASCIIString["TAGTAGGTTTC"]
ATGTGCGGTCG	ASCIIString["TGTGCGGTCGC"]
