GACACGAGATACATTCAGT	SubString{ASCIIString}["ACACGAGATACATTCAGTG"]
GAAGTAACCATGCCGACCC	SubString{ASCIIString}["AAGTAACCATGCCGACCCC"]
GCACTGTGGTTGCAAAATC	SubString{ASCIIString}["CACTGTGGTTGCAAAATCT"]
ACGGCATGCCCTTTTGGCG	SubString{ASCIIString}["CGGCATGCCCTTTTGGCGG"]
ACCTGAATGGATGTCCGAA	SubString{ASCIIString}["CCTGAATGGATGTCCGAAA"]
TTAGTCTTTCCGGAAGGCA	SubString{ASCIIString}["TAGTCTTTCCGGAAGGCAG"]
AAGCGACTTATCATAGAGG	SubString{ASCIIString}["AGCGACTTATCATAGAGGC"]
AGGTCCTAGGACCGTCTCA	SubString{ASCIIString}["GGTCCTAGGACCGTCTCAG"]
GACCCTGCAACCCCGGTTC	SubString{ASCIIString}["ACCCTGCAACCCCGGTTCG"]
CCGAAAATCGCCAAATACG	SubString{ASCIIString}["CGAAAATCGCCAAATACGA"]
CCTTACTTGAGACCGCCAG	SubString{ASCIIString}["CTTACTTGAGACCGCCAGT"]
TGAATCGGGAGGTGCTGGC	SubString{ASCIIString}["GAATCGGGAGGTGCTGGCT"]
CGGTTTCTGGCGCGCGGTT	SubString{ASCIIString}["GGTTTCTGGCGCGCGGTTG"]
AGCCATGAGAGCTGACAGC	SubString{ASCIIString}["GCCATGAGAGCTGACAGCG"]
GTCGCTAAGCAACATTATC	SubString{ASCIIString}["TCGCTAAGCAACATTATCA"]
GTCATTACAGCCGATATAC	SubString{ASCIIString}["TCATTACAGCCGATATACG"]
AGTCCTTTAGTCTTTCCGG	SubString{ASCIIString}["GTCCTTTAGTCTTTCCGGA"]
CGCTTTCAAAGCCTTGTCC	SubString{ASCIIString}["GCTTTCAAAGCCTTGTCCA"]
AAGTAAGTTTAAGGTAATC	SubString{ASCIIString}["AGTAAGTTTAAGGTAATCG"]
CTTTGATTCCGTGACTCGT	SubString{ASCIIString}["TTTGATTCCGTGACTCGTG"]
CGTGTTGCTGCGGGTCGAG	SubString{ASCIIString}["GTGTTGCTGCGGGTCGAGT"]
AGGAGGAGAAGTAACCATG	SubString{ASCIIString}["GGAGGAGAAGTAACCATGC"]
AAATCTCGCCCTCTCTGGT	SubString{ASCIIString}["AATCTCGCCCTCTCTGGTT"]
TACAGCCCTAATAGCTGAC	SubString{ASCIIString}["ACAGCCCTAATAGCTGACA"]
GCTGAGCAAAATATGGGGC	SubString{ASCIIString}["CTGAGCAAAATATGGGGCC"]
TTCTACGTGTCAGCAATAG	SubString{ASCIIString}["TCTACGTGTCAGCAATAGT"]
AGTGTATGCTGCCACACAG	SubString{ASCIIString}["GTGTATGCTGCCACACAGC"]
TCCTGCCTTCATCTTTAAA	SubString{ASCIIString}["CCTGCCTTCATCTTTAAAC"]
CATCTAGGGACTCATTCAA	SubString{ASCIIString}["ATCTAGGGACTCATTCAAT"]
GTCCTTGTCATGGGTTCAT	SubString{ASCIIString}["TCCTTGTCATGGGTTCATG"]
GTAGTCCTCCATAATCGGA	SubString{ASCIIString}["TAGTCCTCCATAATCGGAG"]
AGGCGGAGTTCTAAGCGAC	SubString{ASCIIString}["GGCGGAGTTCTAAGCGACT"]
AGCAGTGTTTAGGCCTCGA	SubString{ASCIIString}["GCAGTGTTTAGGCCTCGAA"]
AACCACTGTGTACCCTGCG	SubString{ASCIIString}["ACCACTGTGTACCCTGCGC"]
GGCTTATTTTGGGCCAGAA	SubString{ASCIIString}["GCTTATTTTGGGCCAGAAC"]
AGTCCGAAAATCGCCAAAT	SubString{ASCIIString}["GTCCGAAAATCGCCAAATA"]
TGTGTACCCTGCGCGGTCA	SubString{ASCIIString}["GTGTACCCTGCGCGGTCAA"]
AAGAAATGATCACCCCGTG	SubString{ASCIIString}["AGAAATGATCACCCCGTGT"]
ATACTTTGATTCCGTGACT	SubString{ASCIIString}["TACTTTGATTCCGTGACTC"]
GACAAGGTCCTAGGACCGT	SubString{ASCIIString}["ACAAGGTCCTAGGACCGTC"]
TTTTCCCCTACGTTTGCCG	SubString{ASCIIString}["TTTCCCCTACGTTTGCCGC"]
TTGTTCGCGGGCATGTAGG	SubString{ASCIIString}["TGTTCGCGGGCATGTAGGA"]
TCCTTACTTGAGACCGCCA	SubString{ASCIIString}["CCTTACTTGAGACCGCCAG"]
GAGTCGCCGGTAAACTCCA	SubString{ASCIIString}["AGTCGCCGGTAAACTCCAA"]
AGCGAACGACGCGGGCTTG	SubString{ASCIIString}["GCGAACGACGCGGGCTTGC"]
TATATGAGCACGGAAAGTC	SubString{ASCIIString}["ATATGAGCACGGAAAGTCA"]
TAGACAGATGTCAAGCACC	SubString{ASCIIString}["AGACAGATGTCAAGCACCC"]
CAAATACGATTATCACATG	SubString{ASCIIString}["AAATACGATTATCACATGT"]
TGTCAGCAATAGTCTAAGC	SubString{ASCIIString}["GTCAGCAATAGTCTAAGCG"]
GCAAAATATGGGGCCTTAT	SubString{ASCIIString}["CAAAATATGGGGCCTTATG"]
ACTCGTGTCGCTAAGCAAC	SubString{ASCIIString}["CTCGTGTCGCTAAGCAACA"]
TGAAAAGATGCAGTAGGCG	SubString{ASCIIString}["GAAAAGATGCAGTAGGCGG"]
CTTCATGACCTGGGTTGCG	SubString{ASCIIString}["TTCATGACCTGGGTTGCGT"]
TATGAGCACGGAAAGTCAG	SubString{ASCIIString}["ATGAGCACGGAAAGTCAGT"]
ACGGGTCTGCATAGTTGAA	SubString{ASCIIString}["CGGGTCTGCATAGTTGAAT"]
GAGGCTTATTTTGGGCCAG	SubString{ASCIIString}["AGGCTTATTTTGGGCCAGA"]
TAAGCGCTACCGTCGTCCT	SubString{ASCIIString}["AAGCGCTACCGTCGTCCTT"]
CATTGTCTAGTTTTCGCAG	SubString{ASCIIString}["ATTGTCTAGTTTTCGCAGC"]
ATGGGTTCATGACCAGGGC	SubString{ASCIIString}["TGGGTTCATGACCAGGGCC"]
CTATACTTATATTCTCGTC	SubString{ASCIIString}["TATACTTATATTCTCGTCG"]
GCCACAGACACCAACCTCT	SubString{ASCIIString}["CCACAGACACCAACCTCTG"]
GGAGAAGTAACCACTGTGT	SubString{ASCIIString}["GAGAAGTAACCACTGTGTA"]
ATCGGAGACATGTTACCAG	SubString{ASCIIString}["TCGGAGACATGTTACCAGA"]
ACTAGTCCGGACCCTGCAA	SubString{ASCIIString}["CTAGTCCGGACCCTGCAAC"]
GCGCTACCGTCGTCCTTGT	SubString{ASCIIString}["CGCTACCGTCGTCCTTGTC"]
TCAGTGGAGTACAAAAATG	SubString{ASCIIString}["CAGTGGAGTACAAAAATGT"]
ATTTTCCCCTACGTTTGCC	SubString{ASCIIString}["TTTTCCCCTACGTTTGCCG"]
ACAGATGTCAAGCACCCAT	SubString{ASCIIString}["CAGATGTCAAGCACCCATC"]
ATATGCAGTGCGTAGGGGG	SubString{ASCIIString}["TATGCAGTGCGTAGGGGGT"]
TCATGGTACCTTAGTCCGA	SubString{ASCIIString}["CATGGTACCTTAGTCCGAA"]
TAGTCTTTCCGGAAGGCAG	SubString{ASCIIString}["AGTCTTTCCGGAAGGCAGT"]
GGGTCGAGTCGCCGGTAAA	SubString{ASCIIString}["GGTCGAGTCGCCGGTAAAC"]
CGGTAAACTCCAAACCTGA	SubString{ASCIIString}["GGTAAACTCCAAACCTGAA"]
ATACAGATTCGTAGACGTT	SubString{ASCIIString}["TACAGATTCGTAGACGTTC"]
AAAAGCCATGTAGGAGGAG	SubString{ASCIIString}["AAAGCCATGTAGGAGGAGA"]
AATGTGCGTACTGCGAATG	SubString{ASCIIString}["ATGTGCGTACTGCGAATGT"]
CCGTTGTTGTGGTCGTGTT	SubString{ASCIIString}["CGTTGTTGTGGTCGTGTTT"]
GGAAGATTTTCCCTGTTCG	SubString{ASCIIString}["GAAGATTTTCCCTGTTCGG"]
GGAGTTCTAAGCGACTTAT	SubString{ASCIIString}["GAGTTCTAAGCGACTTATC"]
CATGTAGGAGGAGAAGTAA	SubString{ASCIIString}["ATGTAGGAGGAGAAGTAAC","ATGTAGGAGGAGAAGTAAC","ATGTAGGAGGAGAAGTAAC","ATGTAGGAGGAGAAGTAAC"]
TGGGGCCTTATGAGTGTAT	SubString{ASCIIString}["GGGGCCTTATGAGTGTATG"]
GACTCGTGTCGCTAAGCAA	SubString{ASCIIString}["ACTCGTGTCGCTAAGCAAC"]
GTGCGTAGGGGGTATGTGG	SubString{ASCIIString}["TGCGTAGGGGGTATGTGGA"]
CGAATGTTTTCAATTGATC	SubString{ASCIIString}["GAATGTTTTCAATTGATCC"]
GTGCAACCAAGTGTAAGGG	SubString{ASCIIString}["TGCAACCAAGTGTAAGGGT"]
TGTTACCAGATCCGAGGAT	SubString{ASCIIString}["GTTACCAGATCCGAGGATC"]
GCTAGCGTGAAAAATTCAC	SubString{ASCIIString}["CTAGCGTGAAAAATTCACG"]
ATTTTGGGCCAGAACGGCC	SubString{ASCIIString}["TTTTGGGCCAGAACGGCCC"]
GCGAACCTAGGCACCCACG	SubString{ASCIIString}["CGAACCTAGGCACCCACGG"]
CCACAGCGAACGACGCGGG	SubString{ASCIIString}["CACAGCGAACGACGCGGGC"]
GTAAACTCCAAACCTGAAT	SubString{ASCIIString}["TAAACTCCAAACCTGAATC"]
TGTGGTTGCAAAATCTCGC	SubString{ASCIIString}["GTGGTTGCAAAATCTCGCC"]
CCTGGGTTGCGTTCGACAG	SubString{ASCIIString}["CTGGGTTGCGTTCGACAGT"]
ACTCGCCCTATATGCAGTG	SubString{ASCIIString}["CTCGCCCTATATGCAGTGC"]
GTTACCAGATCCGAGGATC	SubString{ASCIIString}["TTACCAGATCCGAGGATCT"]
CTGCCACACAGCCACAGAC	SubString{ASCIIString}["TGCCACACAGCCACAGACA"]
CATGGGTTCATGACCAGGG	SubString{ASCIIString}["ATGGGTTCATGACCAGGGC"]
TCCGGGCAGCCAACTAGTT	SubString{ASCIIString}["CCGGGCAGCCAACTAGTTC"]
CGCGCGGTTCTACGTGTCA	SubString{ASCIIString}["GCGCGGTTCTACGTGTCAG"]
GCACCTCGCGCGGTTCTAC	SubString{ASCIIString}["CACCTCGCGCGGTTCTACG"]
CTTATATTCTCGTCGTGAG	SubString{ASCIIString}["TTATATTCTCGTCGTGAGG"]
GTGCATACAGCCCTAATAG	SubString{ASCIIString}["TGCATACAGCCCTAATAGC"]
CCGTCGTCCTTGTCATGGG	SubString{ASCIIString}["CGTCGTCCTTGTCATGGGT"]
TAGTAAAGCGGTTTCTGGC	SubString{ASCIIString}["AGTAAAGCGGTTTCTGGCG"]
AGTGTAAGGGTGTGGAGCA	SubString{ASCIIString}["GTGTAAGGGTGTGGAGCAC"]
AGCAGCGATACTTTCACAC	SubString{ASCIIString}["GCAGCGATACTTTCACACC"]
CTAGATTTACTAAAGCTAG	SubString{ASCIIString}["TAGATTTACTAAAGCTAGC"]
AGTAACATCTTATCTGCTT	SubString{ASCIIString}["GTAACATCTTATCTGCTTT"]
CCCTATATGCAGTGCGTAG	SubString{ASCIIString}["CCTATATGCAGTGCGTAGG"]
CGTCTCAGGAAGTCTACGT	SubString{ASCIIString}["GTCTCAGGAAGTCTACGTT"]
AATGCAAGTAATAAGGTCC	SubString{ASCIIString}["ATGCAAGTAATAAGGTCCC"]
TAATCGCCCGAGTGTCTAT	SubString{ASCIIString}["AATCGCCCGAGTGTCTATA"]
TTTACTAAAGCTAGCCATG	SubString{ASCIIString}["TTACTAAAGCTAGCCATGA"]
GATTCCGTGACTCGTGTCG	SubString{ASCIIString}["ATTCCGTGACTCGTGTCGC"]
TGGCACCTTTATTATCGGC	SubString{ASCIIString}["GGCACCTTTATTATCGGCA"]
TTAACAAGAAATGATCACC	SubString{ASCIIString}["TAACAAGAAATGATCACCC"]
CCGCTTGCGACAAGGTCCT	SubString{ASCIIString}["CGCTTGCGACAAGGTCCTA"]
TAGGCGGAGTTCTAAGCGA	SubString{ASCIIString}["AGGCGGAGTTCTAAGCGAC"]
AAATACGATTATCACATGT	SubString{ASCIIString}["AATACGATTATCACATGTA"]
GCGCGAATTGAGGCCGAAC	SubString{ASCIIString}["CGCGAATTGAGGCCGAACC"]
CTACGGCATTGTCTAGTTT	SubString{ASCIIString}["TACGGCATTGTCTAGTTTT"]
AAAGTTCATGGTACCTTAG	SubString{ASCIIString}["AAGTTCATGGTACCTTAGT"]
CTCAGGAAGTCTACGTTAG	SubString{ASCIIString}["TCAGGAAGTCTACGTTAGG"]
TCCAGACAGACGCTTGAAA	SubString{ASCIIString}["CCAGACAGACGCTTGAAAA"]
TTATATTCTCGTCGTGAGG	SubString{ASCIIString}["TATATTCTCGTCGTGAGGC"]
GAGGCCGAACCCACTAGTC	SubString{ASCIIString}["AGGCCGAACCCACTAGTCC"]
AGAGAAACACGCTGAGCAA	SubString{ASCIIString}["GAGAAACACGCTGAGCAAA"]
GGTCTGCATAGTTGAATCC	SubString{ASCIIString}["GTCTGCATAGTTGAATCCG"]
AGCTCGCGCCCACATCTAG	SubString{ASCIIString}["GCTCGCGCCCACATCTAGG"]
AGCCTTGTCCATCTAAATC	SubString{ASCIIString}["GCCTTGTCCATCTAAATCG"]
GTATGCTGCCACACAGCCA	SubString{ASCIIString}["TATGCTGCCACACAGCCAC"]
CCCTGGCCCACCTGTTTGA	SubString{ASCIIString}["CCTGGCCCACCTGTTTGAA"]
GCAACTTGTTATAGTCCTT	SubString{ASCIIString}["CAACTTGTTATAGTCCTTT"]
TCCGGAAGGCAGTTCATCT	SubString{ASCIIString}["CCGGAAGGCAGTTCATCTC"]
GGTTCTACGTGTCAGCAAT	SubString{ASCIIString}["GTTCTACGTGTCAGCAATA"]
AACTTTTGGTGACTTAACA	SubString{ASCIIString}["ACTTTTGGTGACTTAACAA"]
ACTTTTGGTGACTTAACAA	SubString{ASCIIString}["CTTTTGGTGACTTAACAAG"]
GACCGTCTCAGGAAGTCTA	SubString{ASCIIString}["ACCGTCTCAGGAAGTCTAC"]
AGTTGAATCCGGTACAGGT	SubString{ASCIIString}["GTTGAATCCGGTACAGGTT"]
CAGTTCATCTCCCTGGCCC	SubString{ASCIIString}["AGTTCATCTCCCTGGCCCA"]
GATATACGGGTCTGCATAG	SubString{ASCIIString}["ATATACGGGTCTGCATAGT"]
TTCAATTCTTAGATAATCG	SubString{ASCIIString}["TCAATTCTTAGATAATCGC"]
AGATCCGAGGATCTGGTGG	SubString{ASCIIString}["GATCCGAGGATCTGGTGGC"]
AGGACCGTCTCAGGAAGTC	SubString{ASCIIString}["GGACCGTCTCAGGAAGTCT"]
GTGAGGCTAGATTTACTAA	SubString{ASCIIString}["TGAGGCTAGATTTACTAAA"]
CTGAATCGGGAGGTGCTGG	SubString{ASCIIString}["TGAATCGGGAGGTGCTGGC"]
TTGTTGTGGTCGTGTTTTG	SubString{ASCIIString}["TGTTGTGGTCGTGTTTTGG"]
GCGAATGTTTTCAATTGAT	SubString{ASCIIString}["CGAATGTTTTCAATTGATC"]
TTTGAAAAGTTCATGGTAC	SubString{ASCIIString}["TTGAAAAGTTCATGGTACC"]
ATGGTCATTTAGACAGATG	SubString{ASCIIString}["TGGTCATTTAGACAGATGT"]
GTTCTCCTTACTTGAGACC	SubString{ASCIIString}["TTCTCCTTACTTGAGACCG"]
AAAAAGAAGAGAATACTTT	SubString{ASCIIString}["AAAAGAAGAGAATACTTTG"]
GAGAAGTAACCACTGTGTA	SubString{ASCIIString}["AGAAGTAACCACTGTGTAC"]
GTCCGGAAGATTTTCCCTG	SubString{ASCIIString}["TCCGGAAGATTTTCCCTGT"]
ACAGCCGATATACGGGTCT	SubString{ASCIIString}["CAGCCGATATACGGGTCTG"]
TCTGGTGGCTAGTAAAGCG	SubString{ASCIIString}["CTGGTGGCTAGTAAAGCGG"]
TCAGGCGTGATCTGATGGG	SubString{ASCIIString}["CAGGCGTGATCTGATGGGT"]
CAGACAGACGCTTGAAAAG	SubString{ASCIIString}["AGACAGACGCTTGAAAAGA"]
CCTCCATAATCGGAGACAT	SubString{ASCIIString}["CTCCATAATCGGAGACATG"]
TGAGTGTATGCTGCCACAC	SubString{ASCIIString}["GAGTGTATGCTGCCACACA"]
GGACCGTCTCAGGAAGTCT	SubString{ASCIIString}["GACCGTCTCAGGAAGTCTA"]
GATAATCGCGCGCAAGTTT	SubString{ASCIIString}["ATAATCGCGCGCAAGTTTG"]
GCCCACCTGTTTGAAAAGT	SubString{ASCIIString}["CCCACCTGTTTGAAAAGTT"]
GCATAGTTGAATCCGGTAC	SubString{ASCIIString}["CATAGTTGAATCCGGTACA"]
CTCAGGCGTGATCTGATGG	SubString{ASCIIString}["TCAGGCGTGATCTGATGGG"]
ACTCCGAGCAGCGATACTT	SubString{ASCIIString}["CTCCGAGCAGCGATACTTT"]
TTGCTGCGGGTCGAGTCGC	SubString{ASCIIString}["TGCTGCGGGTCGAGTCGCC"]
TTTGGCCAATGCAAGTAAT	SubString{ASCIIString}["TTGGCCAATGCAAGTAATA"]
AAGTAATAAGGTCCCCGTT	SubString{ASCIIString}["AGTAATAAGGTCCCCGTTG"]
GTTTGCCGCATGGGGACAT	SubString{ASCIIString}["TTTGCCGCATGGGGACATA"]
CTTTATATGAGCACGGAAA	SubString{ASCIIString}["TTTATATGAGCACGGAAAG"]
GCACCCACGGCATGCCCTT	SubString{ASCIIString}["CACCCACGGCATGCCCTTT"]
GCGGTTCTACGTGTCAGCA	SubString{ASCIIString}["CGGTTCTACGTGTCAGCAA"]
CGCTAAGCAACATTATCAA	SubString{ASCIIString}["GCTAAGCAACATTATCAAA"]
TCATGACCTGGGTTGCGTT	SubString{ASCIIString}["CATGACCTGGGTTGCGTTC"]
ATTCCGGCATTCGCCACCC	SubString{ASCIIString}["TTCCGGCATTCGCCACCCA"]
TGGGCCAGAACGGCCCCTA	SubString{ASCIIString}["GGGCCAGAACGGCCCCTAG"]
GTCTAGTTTTCGCAGCTGG	SubString{ASCIIString}["TCTAGTTTTCGCAGCTGGA"]
TTATGAGTGTATGCTGCCA	SubString{ASCIIString}["TATGAGTGTATGCTGCCAC"]
CCACAGACACCAACCTCTG	SubString{ASCIIString}["CACAGACACCAACCTCTGC"]
AACCTAGGCACCCACGGCA	SubString{ASCIIString}["ACCTAGGCACCCACGGCAT"]
GACAGGGGCAGTCATACTG	SubString{ASCIIString}["ACAGGGGCAGTCATACTGG"]
GAGGAGAAGTAACCACTGT	SubString{ASCIIString}["AGGAGAAGTAACCACTGTG"]
TTGATTCCGTGACTCGTGT	SubString{ASCIIString}["TGATTCCGTGACTCGTGTC"]
GCCAAATCACCAACAGGCA	SubString{ASCIIString}["CCAAATCACCAACAGGCAT"]
TTGGCCAATGCAAGTAATA	SubString{ASCIIString}["TGGCCAATGCAAGTAATAA"]
TGCTGCCACACAGCCACAG	SubString{ASCIIString}["GCTGCCACACAGCCACAGA"]
GTGTTGCTGCGGGTCGAGT	SubString{ASCIIString}["TGTTGCTGCGGGTCGAGTC"]
ATTCGCCACCCACAATGAT	SubString{ASCIIString}["TTCGCCACCCACAATGATT"]
CGCCCGAGTGTCTATACTT	SubString{ASCIIString}["GCCCGAGTGTCTATACTTA"]
CTTTCACACCGTGTTTTGA	SubString{ASCIIString}["TTTCACACCGTGTTTTGAT"]
CTGTTCGCAGCCCTACCCG	SubString{ASCIIString}["TGTTCGCAGCCCTACCCGG"]
GCCACACAGCCACAGACAC	SubString{ASCIIString}["CCACACAGCCACAGACACC"]
GTCGTGTTTTGGGGCTCAG	SubString{ASCIIString}["TCGTGTTTTGGGGCTCAGG"]
ACCTTCCAGACAGACGCTT	SubString{ASCIIString}["CCTTCCAGACAGACGCTTG"]
ACCTTTATTATCGGCAATG	SubString{ASCIIString}["CCTTTATTATCGGCAATGC"]
CAAAAAGAAGAGAATACTT	SubString{ASCIIString}["AAAAAGAAGAGAATACTTT"]
TCAACTTTTGGTGACTTAA	SubString{ASCIIString}["CAACTTTTGGTGACTTAAC"]
GCAACCCCGGTTCGCTTGT	SubString{ASCIIString}["CAACCCCGGTTCGCTTGTG"]
CGAAAATCGCCAAATGGCA	SubString{ASCIIString}["GAAAATCGCCAAATGGCAA"]
GTTGAAGACATTTTCCCCT	SubString{ASCIIString}["TTGAAGACATTTTCCCCTA"]
TGGCGGACTCCTGCCTTCA	SubString{ASCIIString}["GGCGGACTCCTGCCTTCAT"]
TTCATGGTACCTTAGTCCG	SubString{ASCIIString}["TCATGGTACCTTAGTCCGA"]
TGGGGCTCAGGCGTGATCT	SubString{ASCIIString}["GGGGCTCAGGCGTGATCTG"]
ACCGTCGTCCTTGTCATGG	SubString{ASCIIString}["CCGTCGTCCTTGTCATGGG"]
GATTAAGTAAGTTTAAGGT	SubString{ASCIIString}["ATTAAGTAAGTTTAAGGTA"]
CCCCTACGTTTGCCGCATG	SubString{ASCIIString}["CCCTACGTTTGCCGCATGG"]
TTATAGTCCTTTAGTCTTT	SubString{ASCIIString}["TATAGTCCTTTAGTCTTTC"]
CTAGTAAAGCGGTTTCTGG	SubString{ASCIIString}["TAGTAAAGCGGTTTCTGGC"]
CGGACCCTGCAACCCCGGT	SubString{ASCIIString}["GGACCCTGCAACCCCGGTT"]
TGCGTTCACATGGTCATTT	SubString{ASCIIString}["GCGTTCACATGGTCATTTA"]
CTTGCGCATCATTCCCTTT	SubString{ASCIIString}["TTGCGCATCATTCCCTTTA"]
AATATAGTCCGGAAGATTT	SubString{ASCIIString}["ATATAGTCCGGAAGATTTT"]
TTCGGTATTCCGGCATTCG	SubString{ASCIIString}["TCGGTATTCCGGCATTCGC"]
ATGTCCGAAAATCGCCAAA	SubString{ASCIIString}["TGTCCGAAAATCGCCAAAT"]
AAGAGAATACTTTGATTCC	SubString{ASCIIString}["AGAGAATACTTTGATTCCG"]
GCCATGTAGGAGGAGAAGT	SubString{ASCIIString}["CCATGTAGGAGGAGAAGTA"]
AGTTTCACTAATTTGTCTT	SubString{ASCIIString}["GTTTCACTAATTTGTCTTG"]
AGTCGCCGGTAAACTCCAA	SubString{ASCIIString}["GTCGCCGGTAAACTCCAAA"]
GGTCGTGTTTTGGGGCTCA	SubString{ASCIIString}["GTCGTGTTTTGGGGCTCAG"]
TTAGCAACAAAAAGAAGAG	SubString{ASCIIString}["TAGCAACAAAAAGAAGAGA"]
GCTCTTCATGACCTGGGTT	SubString{ASCIIString}["CTCTTCATGACCTGGGTTG"]
CTTACCTGAATGGATGTCC	SubString{ASCIIString}["TTACCTGAATGGATGTCCG"]
GTCGTGAGGCTAGATTTAC	SubString{ASCIIString}["TCGTGAGGCTAGATTTACT"]
GTGATCTGATGGGTTTGAC	SubString{ASCIIString}["TGATCTGATGGGTTTGACA"]
CCGAGTGTCTATACTTATA	SubString{ASCIIString}["CGAGTGTCTATACTTATAT"]
ATCGGCAATGCAGCACCAG	SubString{ASCIIString}["TCGGCAATGCAGCACCAGC"]
CCTACTCGCCCTATATGCA	SubString{ASCIIString}["CTACTCGCCCTATATGCAG"]
GGCTTGCGCATCATTCCCT	SubString{ASCIIString}["GCTTGCGCATCATTCCCTT"]
GTGTGGAGCACCTCGCGCG	SubString{ASCIIString}["TGTGGAGCACCTCGCGCGG"]
GTCCGAAAATCGCCAAATA	SubString{ASCIIString}["TCCGAAAATCGCCAAATAC"]
ACCAACCTCTGCACTGTGG	SubString{ASCIIString}["CCAACCTCTGCACTGTGGT"]
CCCACGGCATGCCCTTTTG	SubString{ASCIIString}["CCACGGCATGCCCTTTTGG"]
TTCGCAGCCCTACCCGGTC	SubString{ASCIIString}["TCGCAGCCCTACCCGGTCC"]
AGCCACAGACACCAACCTC	SubString{ASCIIString}["GCCACAGACACCAACCTCT"]
GTCAAGCACCCATCTAGCA	SubString{ASCIIString}["TCAAGCACCCATCTAGCAG"]
CTTTTAATAATACAGATTC	SubString{ASCIIString}["TTTTAATAATACAGATTCG"]
CTGCTTTCACCACAGCGAA	SubString{ASCIIString}["TGCTTTCACCACAGCGAAC"]
GCTAGTAAAGCGGTTTCTG	SubString{ASCIIString}["CTAGTAAAGCGGTTTCTGG"]
CCCTACGTTTGCCGCATGG	SubString{ASCIIString}["CCTACGTTTGCCGCATGGG"]
CACGGAAAGTCAGTGGAGT	SubString{ASCIIString}["ACGGAAAGTCAGTGGAGTA"]
GTAACCATGCCGACCCCAG	SubString{ASCIIString}["TAACCATGCCGACCCCAGC"]
ATACTTTCACACCGTGTTT	SubString{ASCIIString}["TACTTTCACACCGTGTTTT"]
GCTGGCTAGCGTGAAAAAT	SubString{ASCIIString}["CTGGCTAGCGTGAAAAATT"]
GGCGAACCTAGGCACCCAC	SubString{ASCIIString}["GCGAACCTAGGCACCCACG"]
ATCCGGGCAGCCAACTAGT	SubString{ASCIIString}["TCCGGGCAGCCAACTAGTT"]
TGCGTACTGCGAATGTTTT	SubString{ASCIIString}["GCGTACTGCGAATGTTTTC"]
TACAAAAATGTTGGACCCT	SubString{ASCIIString}["ACAAAAATGTTGGACCCTA"]
AAGTCGTGCACAGTAGTCC	SubString{ASCIIString}["AGTCGTGCACAGTAGTCCT"]
CGGTTGGGGGCGCTTTCAA	SubString{ASCIIString}["GGTTGGGGGCGCTTTCAAA"]
GTTCTACGTGTCAGCAATA	SubString{ASCIIString}["TTCTACGTGTCAGCAATAG"]
GATGCAGTAGGCGGAGTTC	SubString{ASCIIString}["ATGCAGTAGGCGGAGTTCT"]
GTAATAAGGTCCCCGTTGT	SubString{ASCIIString}["TAATAAGGTCCCCGTTGTT"]
ATGAGTGTATGCTGCCACA	SubString{ASCIIString}["TGAGTGTATGCTGCCACAC"]
CCTCTGCACTGTGGTTGCA	SubString{ASCIIString}["CTCTGCACTGTGGTTGCAA"]
ACAGATGGCTGAATGTTCC	SubString{ASCIIString}["CAGATGGCTGAATGTTCCT"]
CCTCTCTGGTTCCGTAGCC	SubString{ASCIIString}["CTCTCTGGTTCCGTAGCCG"]
ACCGCTTGCGACAAGGTCC	SubString{ASCIIString}["CCGCTTGCGACAAGGTCCT"]
ACCCACGGCATGCCCTTTT	SubString{ASCIIString}["CCCACGGCATGCCCTTTTG"]
CAGCCCTACCCGGTCCGAA	SubString{ASCIIString}["AGCCCTACCCGGTCCGAAA"]
CGTCGTCCTTGTCATGGGT	SubString{ASCIIString}["GTCGTCCTTGTCATGGGTT"]
GTGAAAAATTCACGGTAGC	SubString{ASCIIString}["TGAAAAATTCACGGTAGCG"]
AAAAGATGCAGTAGGCGGA	SubString{ASCIIString}["AAAGATGCAGTAGGCGGAG"]
CACCTTTATTATCGGCAAT	SubString{ASCIIString}["ACCTTTATTATCGGCAATG"]
CGCTTGCGACAAGGTCCTA	SubString{ASCIIString}["GCTTGCGACAAGGTCCTAG"]
GCATCATTCCCTTTATATG	SubString{ASCIIString}["CATCATTCCCTTTATATGA"]
CATAGAGGCTTATTTTGGG	SubString{ASCIIString}["ATAGAGGCTTATTTTGGGC"]
TTGATTATATCGGTTGAAG	SubString{ASCIIString}["TGATTATATCGGTTGAAGA"]
GCGGGTCGAGTCGCCGGTA	SubString{ASCIIString}["CGGGTCGAGTCGCCGGTAA"]
TTACCAGATCCGAGGATCT	SubString{ASCIIString}["TACCAGATCCGAGGATCTG"]
GCAATGCAGCACCAGCCAG	SubString{ASCIIString}["CAATGCAGCACCAGCCAGT"]
GAGTGTCTATACTTATATT	SubString{ASCIIString}["AGTGTCTATACTTATATTC"]
CTACCGTCGTCCTTGTCAT	SubString{ASCIIString}["TACCGTCGTCCTTGTCATG"]
CCCACTAGTCCGGACCCTG	SubString{ASCIIString}["CCACTAGTCCGGACCCTGC"]
ACACGCTGAGCAAAATATG	SubString{ASCIIString}["CACGCTGAGCAAAATATGG"]
ATAGCTGACAGGGGCAGTC	SubString{ASCIIString}["TAGCTGACAGGGGCAGTCA"]
GGGCTTGCGCATCATTCCC	SubString{ASCIIString}["GGCTTGCGCATCATTCCCT"]
ACCAGCCAGTTCTCCTTAC	SubString{ASCIIString}["CCAGCCAGTTCTCCTTACT"]
CGCGGGCTTGCGCATCATT	SubString{ASCIIString}["GCGGGCTTGCGCATCATTC"]
GGTTTCTGGCGCGCGGTTG	SubString{ASCIIString}["GTTTCTGGCGCGCGGTTGG"]
ATATGAGCACGGAAAGTCA	SubString{ASCIIString}["TATGAGCACGGAAAGTCAG"]
TGTAAGGGTGTGGAGCACC	SubString{ASCIIString}["GTAAGGGTGTGGAGCACCT"]
CATGACCTGGGTTGCGTTC	SubString{ASCIIString}["ATGACCTGGGTTGCGTTCG"]
TGATTCCGTGACTCGTGTC	SubString{ASCIIString}["GATTCCGTGACTCGTGTCG"]
CATTCGCCACCCACAATGA	SubString{ASCIIString}["ATTCGCCACCCACAATGAT"]
TAGCGTGAAAAATTCACGG	SubString{ASCIIString}["AGCGTGAAAAATTCACGGT"]
GCAACCAAGTGTAAGGGTG	SubString{ASCIIString}["CAACCAAGTGTAAGGGTGT"]
AATCGCCAAATGGCAAAAA	SubString{ASCIIString}["ATCGCCAAATGGCAAAAAG"]
GTAGACGTTCAACTTTTGG	SubString{ASCIIString}["TAGACGTTCAACTTTTGGT"]
TCCCTGGCCCACCTGTTTG	SubString{ASCIIString}["CCCTGGCCCACCTGTTTGA"]
ACAAAAAGAAGAGAATACT	SubString{ASCIIString}["CAAAAAGAAGAGAATACTT"]
CCATGTAGGAGGAGAAGTA	SubString{ASCIIString}["CATGTAGGAGGAGAAGTAA"]
ACCATGCCGACCCCAGCTC	SubString{ASCIIString}["CCATGCCGACCCCAGCTCG"]
ATCTACGGCATTGTCTAGT	SubString{ASCIIString}["TCTACGGCATTGTCTAGTT"]
CAAGGTCCTAGGACCGTCT	SubString{ASCIIString}["AAGGTCCTAGGACCGTCTC"]
CAAGCACCCATCTAGCAGT	SubString{ASCIIString}["AAGCACCCATCTAGCAGTG"]
CCACAACAAGAGAAACACG	SubString{ASCIIString}["CACAACAAGAGAAACACGC"]
TTCCACAGATGGCTGAATG	SubString{ASCIIString}["TCCACAGATGGCTGAATGT"]
TACCCGGTCCGAAAATCGC	SubString{ASCIIString}["ACCCGGTCCGAAAATCGCC"]
TACAGATTCGTAGACGTTC	SubString{ASCIIString}["ACAGATTCGTAGACGTTCA"]
AAGCACCCATCTAGCAGTG	SubString{ASCIIString}["AGCACCCATCTAGCAGTGT"]
TAATACAGATTCGTAGACG	SubString{ASCIIString}["AATACAGATTCGTAGACGT"]
AGTGTCTATACTTATATTC	SubString{ASCIIString}["GTGTCTATACTTATATTCT"]
TTCCCTTTATATGAGCACG	SubString{ASCIIString}["TCCCTTTATATGAGCACGG"]
CTTATTTTGGCCAATGCAA	SubString{ASCIIString}["TTATTTTGGCCAATGCAAG"]
TCCTCTTTTAATAATACAG	SubString{ASCIIString}["CCTCTTTTAATAATACAGA"]
CCAATGCAAGTAATAAGGT	SubString{ASCIIString}["CAATGCAAGTAATAAGGTC"]
GGTTCGCTTGTGCGTTCAC	SubString{ASCIIString}["GTTCGCTTGTGCGTTCACA"]
GATGTCAAGCACCCATCTA	SubString{ASCIIString}["ATGTCAAGCACCCATCTAG"]
CTTCGGTATTCCGGCATTC	SubString{ASCIIString}["TTCGGTATTCCGGCATTCG"]
CACCTGTTTGAAAAGTTCA	SubString{ASCIIString}["ACCTGTTTGAAAAGTTCAT"]
TTGATCCTCTTTTAATAAT	SubString{ASCIIString}["TGATCCTCTTTTAATAATA"]
GTTCCTACTCGCCCTATAT	SubString{ASCIIString}["TTCCTACTCGCCCTATATG"]
GGAGAAGTAACATCTTATC	SubString{ASCIIString}["GAGAAGTAACATCTTATCT"]
TATGAGTGTATGCTGCCAC	SubString{ASCIIString}["ATGAGTGTATGCTGCCACA"]
GCGGAGTTCTAAGCGACTT	SubString{ASCIIString}["CGGAGTTCTAAGCGACTTA"]
ATCTCGCCCTCTCTGGTTC	SubString{ASCIIString}["TCTCGCCCTCTCTGGTTCC"]
ACGTCCGAAAATCGCCAAA	SubString{ASCIIString}["CGTCCGAAAATCGCCAAAT"]
CACTGTGTACCCTGCGCGG	SubString{ASCIIString}["ACTGTGTACCCTGCGCGGT"]
AGGGGTCATTACAGCCGAT	SubString{ASCIIString}["GGGGTCATTACAGCCGATA"]
AAAAATTCACGGTAGCGCG	SubString{ASCIIString}["AAAATTCACGGTAGCGCGA"]
GCCAATGCAAGTAATAAGG	SubString{ASCIIString}["CCAATGCAAGTAATAAGGT"]
TGGGTTTGACACGAGATAC	SubString{ASCIIString}["GGGTTTGACACGAGATACA"]
TTCACCACAGCGAACGACG	SubString{ASCIIString}["TCACCACAGCGAACGACGC"]
TGCTTTCACCACAGCGAAC	SubString{ASCIIString}["GCTTTCACCACAGCGAACG"]
CAGGGGCAGTCATACTGGA	SubString{ASCIIString}["AGGGGCAGTCATACTGGAC"]
TACAGGTTAATGTGCGTAC	SubString{ASCIIString}["ACAGGTTAATGTGCGTACT"]
ATTATATCGGTTGAAGACA	SubString{ASCIIString}["TTATATCGGTTGAAGACAT"]
TGCAACCAAGTGTAAGGGT	SubString{ASCIIString}["GCAACCAAGTGTAAGGGTG"]
TAGGCCTCGAAAAACCAAT	SubString{ASCIIString}["AGGCCTCGAAAAACCAATC"]
GTGTAAGGGTGTGGAGCAC	SubString{ASCIIString}["TGTAAGGGTGTGGAGCACC"]
AGCTGGAAGTTTCACTAAT	SubString{ASCIIString}["GCTGGAAGTTTCACTAATT"]
TGACCTAATATAGTCCGGA	SubString{ASCIIString}["GACCTAATATAGTCCGGAA"]
TGGGAGATGCCGCCATCTA	SubString{ASCIIString}["GGGAGATGCCGCCATCTAC"]
CGGTCCGAAAATCGCCAAA	SubString{ASCIIString}["GGTCCGAAAATCGCCAAAT"]
CAACTAGTTCTGACCTAAT	SubString{ASCIIString}["AACTAGTTCTGACCTAATA"]
CCAGCCAGTTCTCCTTACT	SubString{ASCIIString}["CAGCCAGTTCTCCTTACTT"]
TCGTGCAACCAAGTGTAAG	SubString{ASCIIString}["CGTGCAACCAAGTGTAAGG"]
GGGAGGTGCTGGCTAGCGT	SubString{ASCIIString}["GGAGGTGCTGGCTAGCGTG"]
TACTGGACATGGCACCTTT	SubString{ASCIIString}["ACTGGACATGGCACCTTTA"]
CTTCCAGACAGACGCTTGA	SubString{ASCIIString}["TTCCAGACAGACGCTTGAA"]
CCGGTTCGCTTGTGCGTTC	SubString{ASCIIString}["CGGTTCGCTTGTGCGTTCA"]
TGGGTTCATGACCAGGGCC	SubString{ASCIIString}["GGGTTCATGACCAGGGCCT"]
CTCTGCACTGTGGTTGCAA	SubString{ASCIIString}["TCTGCACTGTGGTTGCAAA"]
CACCCACAATGATTCGGGC	SubString{ASCIIString}["ACCCACAATGATTCGGGCG"]
TAACCATGCCGACCCCAGC	SubString{ASCIIString}["AACCATGCCGACCCCAGCT"]
AATACGATTATCACATGTA	SubString{ASCIIString}["ATACGATTATCACATGTAG"]
GGGCTCAGGCGTGATCTGA	SubString{ASCIIString}["GGCTCAGGCGTGATCTGAT"]
TGGCAAAAAGCCATGTAGG	SubString{ASCIIString}["GGCAAAAAGCCATGTAGGA"]
AAGGTAATCGCCCGAGTGT	SubString{ASCIIString}["AGGTAATCGCCCGAGTGTC"]
CGTTGTTGTGGTCGTGTTT	SubString{ASCIIString}["GTTGTTGTGGTCGTGTTTT"]
GTTTCACTAATTTGTCTTG	SubString{ASCIIString}["TTTCACTAATTTGTCTTGA"]
TAGTCCGGACCCTGCAACC	SubString{ASCIIString}["AGTCCGGACCCTGCAACCC"]
AAGATGCAGTAGGCGGAGT	SubString{ASCIIString}["AGATGCAGTAGGCGGAGTT"]
TGACAGCGCGTGGGAGATG	SubString{ASCIIString}["GACAGCGCGTGGGAGATGC"]
CTTATTTTGGGCCAGAACG	SubString{ASCIIString}["TTATTTTGGGCCAGAACGG"]
CCCTGGCGAACCTAGGCAC	SubString{ASCIIString}["CCTGGCGAACCTAGGCACC"]
CCTATGACCTTCCAGACAG	SubString{ASCIIString}["CTATGACCTTCCAGACAGA"]
ATACGATTATCACATGTAG	SubString{ASCIIString}["TACGATTATCACATGTAGG"]
GCTGACAGGGGCAGTCATA	SubString{ASCIIString}["CTGACAGGGGCAGTCATAC"]
TCGTGTCGCTAAGCAACAT	SubString{ASCIIString}["CGTGTCGCTAAGCAACATT"]
AAAGCGGTTTCTGGCGCGC	SubString{ASCIIString}["AAGCGGTTTCTGGCGCGCG"]
GCTGCGGGTCGAGTCGCCG	SubString{ASCIIString}["CTGCGGGTCGAGTCGCCGG"]
TACGTTAGGAGTGTCCACC	SubString{ASCIIString}["ACGTTAGGAGTGTCCACCT"]
GCGTACTGCGAATGTTTTC	SubString{ASCIIString}["CGTACTGCGAATGTTTTCA"]
ATCCTCTTTTAATAATACA	SubString{ASCIIString}["TCCTCTTTTAATAATACAG"]
AGTTCTAAGCGACTTATCA	SubString{ASCIIString}["GTTCTAAGCGACTTATCAT"]
GCTAGATTTACTAAAGCTA	SubString{ASCIIString}["CTAGATTTACTAAAGCTAG"]
CGGCATGCCCTTTTGGCGG	SubString{ASCIIString}["GGCATGCCCTTTTGGCGGA"]
CCAGTTCTCCTTACTTGAG	SubString{ASCIIString}["CAGTTCTCCTTACTTGAGA"]
AGGAGGAGAAGTAACCACT	SubString{ASCIIString}["GGAGGAGAAGTAACCACTG"]
AAGCTAGCCATGAGAGCTG	SubString{ASCIIString}["AGCTAGCCATGAGAGCTGA"]
TTTGATTATATCGGTTGAA	SubString{ASCIIString}["TTGATTATATCGGTTGAAG"]
GTTCGCGGGCATGTAGGAG	SubString{ASCIIString}["TTCGCGGGCATGTAGGAGG"]
GCAAGTTTGCATTCCACAG	SubString{ASCIIString}["CAAGTTTGCATTCCACAGA"]
CGTGACTCGTGTCGCTAAG	SubString{ASCIIString}["GTGACTCGTGTCGCTAAGC"]
AATACTTTGATTCCGTGAC	SubString{ASCIIString}["ATACTTTGATTCCGTGACT"]
TTATATGAGCACGGAAAGT	SubString{ASCIIString}["TATATGAGCACGGAAAGTC"]
GAAGGCAGTTCATCTCCCT	SubString{ASCIIString}["AAGGCAGTTCATCTCCCTG"]
ATTTACTAAAGCTAGCCAT	SubString{ASCIIString}["TTTACTAAAGCTAGCCATG"]
AGAAGTAACATCTTATCTG	SubString{ASCIIString}["GAAGTAACATCTTATCTGC"]
GTCAGTGGAGTACAAAAAT	SubString{ASCIIString}["TCAGTGGAGTACAAAAATG"]
CTACCCGGTCCGAAAATCG	SubString{ASCIIString}["TACCCGGTCCGAAAATCGC"]
GGTTGGGGGCGCTTTCAAA	SubString{ASCIIString}["GTTGGGGGCGCTTTCAAAG"]
TTGAAAAGATGCAGTAGGC	SubString{ASCIIString}["TGAAAAGATGCAGTAGGCG"]
TCCTAGGACCGTCTCAGGA	SubString{ASCIIString}["CCTAGGACCGTCTCAGGAA"]
AAGTAACCACTGTGTACCC	SubString{ASCIIString}["AGTAACCACTGTGTACCCT"]
TTTGGTGACTTAACAAGAA	SubString{ASCIIString}["TTGGTGACTTAACAAGAAA"]
CGTGGGCAACTTGTTATAG	SubString{ASCIIString}["GTGGGCAACTTGTTATAGT"]
TTGTGGTCGTGTTTTGGGG	SubString{ASCIIString}["TGTGGTCGTGTTTTGGGGC"]
GCGAATTGAGGCCGAACCC	SubString{ASCIIString}["CGAATTGAGGCCGAACCCA"]
TTCACATGGTCATTTAGAC	SubString{ASCIIString}["TCACATGGTCATTTAGACA"]
GCCGCTCTATCGGCTCTTC	SubString{ASCIIString}["CCGCTCTATCGGCTCTTCA"]
ACCCCGGTTCGCTTGTGCG	SubString{ASCIIString}["CCCCGGTTCGCTTGTGCGT"]
AGCACCCATCTAGCAGTGT	SubString{ASCIIString}["GCACCCATCTAGCAGTGTT"]
AGACAGACGCTTGAAAAGA	SubString{ASCIIString}["GACAGACGCTTGAAAAGAT"]
CACCACAGCGAACGACGCG	SubString{ASCIIString}["ACCACAGCGAACGACGCGG"]
GTGTACCCTGCGCGGTCAA	SubString{ASCIIString}["TGTACCCTGCGCGGTCAAC"]
TGAGCACGGAAAGTCAGTG	SubString{ASCIIString}["GAGCACGGAAAGTCAGTGG"]
CATAATCGGAGACATGTTA	SubString{ASCIIString}["ATAATCGGAGACATGTTAC"]
AATAGCTGACAGGGGCAGT	SubString{ASCIIString}["ATAGCTGACAGGGGCAGTC"]
TCATCTTTAAACAGTGTGC	SubString{ASCIIString}["CATCTTTAAACAGTGTGCA"]
TCATTACAGCCGATATACG	SubString{ASCIIString}["CATTACAGCCGATATACGG"]
TTCGCGCTTACCTGAATGG	SubString{ASCIIString}["TCGCGCTTACCTGAATGGA"]
CAAACCTGAATCGGGAGGT	SubString{ASCIIString}["AAACCTGAATCGGGAGGTG"]
CCAAATTGTTCGCGGGCAT	SubString{ASCIIString}["CAAATTGTTCGCGGGCATG"]
CTGCCTTCATCTTTAAACA	SubString{ASCIIString}["TGCCTTCATCTTTAAACAG"]
GTCTATACTTATATTCTCG	SubString{ASCIIString}["TCTATACTTATATTCTCGT"]
GCGACACCACAACAAGAGA	SubString{ASCIIString}["CGACACCACAACAAGAGAA"]
CACAGCCACAGACACCAAC	SubString{ASCIIString}["ACAGCCACAGACACCAACC"]
CTAAGCAACATTATCAAAT	SubString{ASCIIString}["TAAGCAACATTATCAAATC"]
CTTTATTATCGGCAATGCA	SubString{ASCIIString}["TTTATTATCGGCAATGCAG"]
AAGCGCTACCGTCGTCCTT	SubString{ASCIIString}["AGCGCTACCGTCGTCCTTG"]
TTTCCCTGTTCGGCCGATT	SubString{ASCIIString}["TTCCCTGTTCGGCCGATTA"]
AAGTAACATCTTATCTGCT	SubString{ASCIIString}["AGTAACATCTTATCTGCTT"]
GTTAGTTTCGCGCTTACCT	SubString{ASCIIString}["TTAGTTTCGCGCTTACCTG"]
ACAGGCATGTAGGAGGAGA	SubString{ASCIIString}["CAGGCATGTAGGAGGAGAA"]
AGGCATGTAGGAGGAGAAG	SubString{ASCIIString}["GGCATGTAGGAGGAGAAGT"]
CATTCCACAGATGGCTGAA	SubString{ASCIIString}["ATTCCACAGATGGCTGAAT"]
GACCCCAGCTCGCGCCCAC	SubString{ASCIIString}["ACCCCAGCTCGCGCCCACA"]
TTCTTCGGTATTCCGGCAT	SubString{ASCIIString}["TCTTCGGTATTCCGGCATT"]
CGCATCATTCCCTTTATAT	SubString{ASCIIString}["GCATCATTCCCTTTATATG"]
TTGTCCATCTAAATCGTGC	SubString{ASCIIString}["TGTCCATCTAAATCGTGCA"]
AGGGTGTGGAGCACCTCGC	SubString{ASCIIString}["GGGTGTGGAGCACCTCGCG"]
TGGCTAGCGTGAAAAATTC	SubString{ASCIIString}["GGCTAGCGTGAAAAATTCA"]
GGCCGATTAAGTAAGTTTA	SubString{ASCIIString}["GCCGATTAAGTAAGTTTAA"]
CCTTCATCTTTAAACAGTG	SubString{ASCIIString}["CTTCATCTTTAAACAGTGT"]
GAGTGTCCACCTATGACCT	SubString{ASCIIString}["AGTGTCCACCTATGACCTT"]
TGCCGCCATCTACGGCATT	SubString{ASCIIString}["GCCGCCATCTACGGCATTG"]
CAGGTTAATGTGCGTACTG	SubString{ASCIIString}["AGGTTAATGTGCGTACTGC"]
GCACCAGCCAGTTCTCCTT	SubString{ASCIIString}["CACCAGCCAGTTCTCCTTA"]
CGTTCACATGGTCATTTAG	SubString{ASCIIString}["GTTCACATGGTCATTTAGA"]
CTCTGGTTCCGTAGCCGCT	SubString{ASCIIString}["TCTGGTTCCGTAGCCGCTC"]
GGAGCACCTCGCGCGGTTC	SubString{ASCIIString}["GAGCACCTCGCGCGGTTCT"]
CCATTTTCTTCGGTATTCC	SubString{ASCIIString}["CATTTTCTTCGGTATTCCG"]
ACTGGACATGGCACCTTTA	SubString{ASCIIString}["CTGGACATGGCACCTTTAT"]
TAACCGCTTGCGACAAGGT	SubString{ASCIIString}["AACCGCTTGCGACAAGGTC"]
CTAACCGCCCCTGGCGAAC	SubString{ASCIIString}["TAACCGCCCCTGGCGAACC"]
ACACCAACCTCTGCACTGT	SubString{ASCIIString}["CACCAACCTCTGCACTGTG"]
GTTTTCGCAGCTGGAAGTT	SubString{ASCIIString}["TTTTCGCAGCTGGAAGTTT"]
GTGTCTATACTTATATTCT	SubString{ASCIIString}["TGTCTATACTTATATTCTC"]
CAGTGTTTAGGCCTCGAAA	SubString{ASCIIString}["AGTGTTTAGGCCTCGAAAA"]
CGTGAAAAATTCACGGTAG	SubString{ASCIIString}["GTGAAAAATTCACGGTAGC"]
CCGCATGGGGACATATCTA	SubString{ASCIIString}["CGCATGGGGACATATCTAA"]
ATATGGGGCCTTATGAGTG	SubString{ASCIIString}["TATGGGGCCTTATGAGTGT"]
TGCTGCGGGTCGAGTCGCC	SubString{ASCIIString}["GCTGCGGGTCGAGTCGCCG"]
CGAGATACATTCAGTGTGA	SubString{ASCIIString}["GAGATACATTCAGTGTGAG"]
TCTATACGTCCGAAAATCG	SubString{ASCIIString}["CTATACGTCCGAAAATCGC"]
CGCAGCCCTACCCGGTCCG	SubString{ASCIIString}["GCAGCCCTACCCGGTCCGA"]
AATTGAGGCCGAACCCACT	SubString{ASCIIString}["ATTGAGGCCGAACCCACTA"]
TTCCGGAAGGCAGTTCATC	SubString{ASCIIString}["TCCGGAAGGCAGTTCATCT"]
CCACTGTGTACCCTGCGCG	SubString{ASCIIString}["CACTGTGTACCCTGCGCGG"]
ACTTATTTTGGCCAATGCA	SubString{ASCIIString}["CTTATTTTGGCCAATGCAA"]
TCGCCGGTAAACTCCAAAC	SubString{ASCIIString}["CGCCGGTAAACTCCAAACC"]
ATGTGGAACTTATTTTGGC	SubString{ASCIIString}["TGTGGAACTTATTTTGGCC"]
CGCCGGTAAACTCCAAACC	SubString{ASCIIString}["GCCGGTAAACTCCAAACCT"]
GAACCCACTAGTCCGGACC	SubString{ASCIIString}["AACCCACTAGTCCGGACCC"]
CCTATATGCAGTGCGTAGG	SubString{ASCIIString}["CTATATGCAGTGCGTAGGG"]
CAAGTAATAAGGTCCCCGT	SubString{ASCIIString}["AAGTAATAAGGTCCCCGTT"]
ATAGTTGAATCCGGTACAG	SubString{ASCIIString}["TAGTTGAATCCGGTACAGG"]
CGAGGATCTGGTGGCTAGT	SubString{ASCIIString}["GAGGATCTGGTGGCTAGTA"]
GTCGCCGGTAAACTCCAAA	SubString{ASCIIString}["TCGCCGGTAAACTCCAAAC"]
TGTCCATCTAAATCGTGCA	SubString{ASCIIString}["GTCCATCTAAATCGTGCAA"]
CCGATATACGGGTCTGCAT	SubString{ASCIIString}["CGATATACGGGTCTGCATA"]
ATCATAGAGGCTTATTTTG	SubString{ASCIIString}["TCATAGAGGCTTATTTTGG"]
CTTTCACCACAGCGAACGA	SubString{ASCIIString}["TTTCACCACAGCGAACGAC"]
GATCACCCCGTGTTGCTGC	SubString{ASCIIString}["ATCACCCCGTGTTGCTGCG"]
CACACCGTGTTTTGATTAT	SubString{ASCIIString}["ACACCGTGTTTTGATTATA"]
GGGGTCATTACAGCCGATA	SubString{ASCIIString}["GGGTCATTACAGCCGATAT"]
ATATTCTCGTCGTGAGGCT	SubString{ASCIIString}["TATTCTCGTCGTGAGGCTA"]
ATTCGTAGACGTTCAACTT	SubString{ASCIIString}["TTCGTAGACGTTCAACTTT"]
GGGTGTGGAGCACCTCGCG	SubString{ASCIIString}["GGTGTGGAGCACCTCGCGC"]
AGGAGAAGTAACATCTTAT	SubString{ASCIIString}["GGAGAAGTAACATCTTATC"]
TGGTGGCTAGTAAAGCGGT	SubString{ASCIIString}["GGTGGCTAGTAAAGCGGTT"]
CGTGAGGCTAGATTTACTA	SubString{ASCIIString}["GTGAGGCTAGATTTACTAA"]
CTAGACTCCGAGCAGCGAT	SubString{ASCIIString}["TAGACTCCGAGCAGCGATA"]
TTCCGGCATTCGCCACCCA	SubString{ASCIIString}["TCCGGCATTCGCCACCCAC"]
CATCATTCCCTTTATATGA	SubString{ASCIIString}["ATCATTCCCTTTATATGAG"]
GCGCTTACCTGAATGGATG	SubString{ASCIIString}["CGCTTACCTGAATGGATGT"]
TTGTTATAGTCCTTTAGTC	SubString{ASCIIString}["TGTTATAGTCCTTTAGTCT"]
TAGTTTCGCGCTTACCTGA	SubString{ASCIIString}["AGTTTCGCGCTTACCTGAA"]
TCGGTATTCCGGCATTCGC	SubString{ASCIIString}["CGGTATTCCGGCATTCGCC"]
AGAAGAGAATACTTTGATT	SubString{ASCIIString}["GAAGAGAATACTTTGATTC"]
AATCGCGCGCAAGTTTGCA	SubString{ASCIIString}["ATCGCGCGCAAGTTTGCAT"]
AGAGAATACTTTGATTCCG	SubString{ASCIIString}["GAGAATACTTTGATTCCGT"]
TCTGGTTCCGTAGCCGCTC	SubString{ASCIIString}["CTGGTTCCGTAGCCGCTCT"]
CTCATTCAATTCTTAGATA	SubString{ASCIIString}["TCATTCAATTCTTAGATAA"]
AACATTATCAAATCCGGGC	SubString{ASCIIString}["ACATTATCAAATCCGGGCA"]
TGATGGGTTTGACACGAGA	SubString{ASCIIString}["GATGGGTTTGACACGAGAT"]
ATCGCCCGAGTGTCTATAC	SubString{ASCIIString}["TCGCCCGAGTGTCTATACT"]
CTTGTGCGTTCACATGGTC	SubString{ASCIIString}["TTGTGCGTTCACATGGTCA"]
AGGCTTATTTTGGGCCAGA	SubString{ASCIIString}["GGCTTATTTTGGGCCAGAA"]
CCCAGCTCGCGCCCACATC	SubString{ASCIIString}["CCAGCTCGCGCCCACATCT"]
TTTCGCGCTTACCTGAATG	SubString{ASCIIString}["TTCGCGCTTACCTGAATGG"]
CGCGCTTACCTGAATGGAT	SubString{ASCIIString}["GCGCTTACCTGAATGGATG"]
CCTCGAAAAACCAATCTAT	SubString{ASCIIString}["CTCGAAAAACCAATCTATA"]
AAACTCCAAACCTGAATCG	SubString{ASCIIString}["AACTCCAAACCTGAATCGG"]
AAGCCTTGTCCATCTAAAT	SubString{ASCIIString}["AGCCTTGTCCATCTAAATC"]
TATCGGCAATGCAGCACCA	SubString{ASCIIString}["ATCGGCAATGCAGCACCAG"]
ACGTTAGGAGTGTCCACCT	SubString{ASCIIString}["CGTTAGGAGTGTCCACCTA"]
CGATATACGGGTCTGCATA	SubString{ASCIIString}["GATATACGGGTCTGCATAG"]
TCTGCTTTCACCACAGCGA	SubString{ASCIIString}["CTGCTTTCACCACAGCGAA"]
AGTTTCGCGCTTACCTGAA	SubString{ASCIIString}["GTTTCGCGCTTACCTGAAT"]
CGACGCGGGCTTGCGCATC	SubString{ASCIIString}["GACGCGGGCTTGCGCATCA"]
TGCAAGTAATAAGGTCCCC	SubString{ASCIIString}["GCAAGTAATAAGGTCCCCG"]
CTAATATAGTCCGGAAGAT	SubString{ASCIIString}["TAATATAGTCCGGAAGATT"]
GTTGCAAAATCTCGCCCTC	SubString{ASCIIString}["TTGCAAAATCTCGCCCTCT"]
TATCAACGCCCATTTTCTT	SubString{ASCIIString}["ATCAACGCCCATTTTCTTC"]
CTCGTCGTGAGGCTAGATT	SubString{ASCIIString}["TCGTCGTGAGGCTAGATTT"]
GTAATCGCCCGAGTGTCTA	SubString{ASCIIString}["TAATCGCCCGAGTGTCTAT"]
CATACTGGACATGGCACCT	SubString{ASCIIString}["ATACTGGACATGGCACCTT"]
GTCATACTGGACATGGCAC	SubString{ASCIIString}["TCATACTGGACATGGCACC"]
TTAATAATACAGATTCGTA	SubString{ASCIIString}["TAATAATACAGATTCGTAG"]
CTGCGCGGTCAACTGGGAA	SubString{ASCIIString}["TGCGCGGTCAACTGGGAAG"]
AACTCCAAACCTGAATCGG	SubString{ASCIIString}["ACTCCAAACCTGAATCGGG"]
CCCGTTGTTGTGGTCGTGT	SubString{ASCIIString}["CCGTTGTTGTGGTCGTGTT"]
GTCGTCCTTGTCATGGGTT	SubString{ASCIIString}["TCGTCCTTGTCATGGGTTC"]
GCGTAGGGGGTATGTGGAA	SubString{ASCIIString}["CGTAGGGGGTATGTGGAAC"]
GCCTCGAAAAACCAATCTA	SubString{ASCIIString}["CCTCGAAAAACCAATCTAT"]
ATTTAGACAGATGTCAAGC	SubString{ASCIIString}["TTTAGACAGATGTCAAGCA"]
TTGAAGACATTTTCCCCTA	SubString{ASCIIString}["TGAAGACATTTTCCCCTAC"]
ACATTTTCCCCTACGTTTG	SubString{ASCIIString}["CATTTTCCCCTACGTTTGC"]
TTCGGGCGACACCACAACA	SubString{ASCIIString}["TCGGGCGACACCACAACAA"]
TTAAGTAAGTTTAAGGTAA	SubString{ASCIIString}["TAAGTAAGTTTAAGGTAAT"]
ATTCAATTCTTAGATAATC	SubString{ASCIIString}["TTCAATTCTTAGATAATCG"]
CGGAAGATTTTCCCTGTTC	SubString{ASCIIString}["GGAAGATTTTCCCTGTTCG"]
AGTAACCGCTTGCGACAAG	SubString{ASCIIString}["GTAACCGCTTGCGACAAGG"]
GCGTTCACATGGTCATTTA	SubString{ASCIIString}["CGTTCACATGGTCATTTAG"]
TTTTCTTCGGTATTCCGGC	SubString{ASCIIString}["TTTCTTCGGTATTCCGGCA"]
CCGATTAAGTAAGTTTAAG	SubString{ASCIIString}["CGATTAAGTAAGTTTAAGG"]
CTGGAAGTTTCACTAATTT	SubString{ASCIIString}["TGGAAGTTTCACTAATTTG"]
TAACAAGAAATGATCACCC	SubString{ASCIIString}["AACAAGAAATGATCACCCC"]
ACACGAGATACATTCAGTG	SubString{ASCIIString}["CACGAGATACATTCAGTGT"]
CACCAACAGGCATGTAGGA	SubString{ASCIIString}["ACCAACAGGCATGTAGGAG"]
CTGTGGTTGCAAAATCTCG	SubString{ASCIIString}["TGTGGTTGCAAAATCTCGC"]
CTGACCTAATATAGTCCGG	SubString{ASCIIString}["TGACCTAATATAGTCCGGA"]
GCTAAGCAACATTATCAAA	SubString{ASCIIString}["CTAAGCAACATTATCAAAT"]
GACAGTTAGCAACAAAAAG	SubString{ASCIIString}["ACAGTTAGCAACAAAAAGA"]
AACCCCGGTTCGCTTGTGC	SubString{ASCIIString}["ACCCCGGTTCGCTTGTGCG"]
GCCAAATACGATTATCACA	SubString{ASCIIString}["CCAAATACGATTATCACAT"]
AAGGTCCTAGGACCGTCTC	SubString{ASCIIString}["AGGTCCTAGGACCGTCTCA"]
TGCCCTTTTGGCGGACTCC	SubString{ASCIIString}["GCCCTTTTGGCGGACTCCT"]
ACAGTTAGCAACAAAAAGA	SubString{ASCIIString}["CAGTTAGCAACAAAAAGAA"]
ACATGGCACCTTTATTATC	SubString{ASCIIString}["CATGGCACCTTTATTATCG"]
CGCGGTCAACTGGGAAGTC	SubString{ASCIIString}["GCGGTCAACTGGGAAGTCG"]
GGACATATCTAACCGCCCC	SubString{ASCIIString}["GACATATCTAACCGCCCCT"]
CCAAGTGTAAGGGTGTGGA	SubString{ASCIIString}["CAAGTGTAAGGGTGTGGAG"]
CGAGTGTCTATACTTATAT	SubString{ASCIIString}["GAGTGTCTATACTTATATT"]
GCCTTGTCCATCTAAATCG	SubString{ASCIIString}["CCTTGTCCATCTAAATCGT"]
GGCACCTTTATTATCGGCA	SubString{ASCIIString}["GCACCTTTATTATCGGCAA"]
AAAGTCAGTGGAGTACAAA	SubString{ASCIIString}["AAGTCAGTGGAGTACAAAA"]
TGCATAGTTGAATCCGGTA	SubString{ASCIIString}["GCATAGTTGAATCCGGTAC"]
GGCAATGCAGCACCAGCCA	SubString{ASCIIString}["GCAATGCAGCACCAGCCAG"]
CTCCATAATCGGAGACATG	SubString{ASCIIString}["TCCATAATCGGAGACATGT"]
TCTATACTTATATTCTCGT	SubString{ASCIIString}["CTATACTTATATTCTCGTC"]
ATTGAGGCCGAACCCACTA	SubString{ASCIIString}["TTGAGGCCGAACCCACTAG"]
GAATGTTTTCAATTGATCC	SubString{ASCIIString}["AATGTTTTCAATTGATCCT"]
TGAAGACATTTTCCCCTAC	SubString{ASCIIString}["GAAGACATTTTCCCCTACG"]
GTCGAGTCGCCGGTAAACT	SubString{ASCIIString}["TCGAGTCGCCGGTAAACTC"]
ATCACCCCGTGTTGCTGCG	SubString{ASCIIString}["TCACCCCGTGTTGCTGCGG"]
CAGTTCTCCTTACTTGAGA	SubString{ASCIIString}["AGTTCTCCTTACTTGAGAC"]
GTAACCACTGTGTACCCTG	SubString{ASCIIString}["TAACCACTGTGTACCCTGC"]
GGAGGAGAAGTAACCACTG	SubString{ASCIIString}["GAGGAGAAGTAACCACTGT"]
ATGTAGGAGGAGAAGTAAC	SubString{ASCIIString}["TGTAGGAGGAGAAGTAACC","TGTAGGAGGAGAAGTAACC","TGTAGGAGGAGAAGTAACC","TGTAGGAGGAGAAGTAACA"]
CCTATCCGTGGGCAACTTG	SubString{ASCIIString}["CTATCCGTGGGCAACTTGT"]
CCCCAGCTCGCGCCCACAT	SubString{ASCIIString}["CCCAGCTCGCGCCCACATC"]
TGGGAAGTCGTGCACAGTA	SubString{ASCIIString}["GGGAAGTCGTGCACAGTAG"]
CCCGAGTGTCTATACTTAT	SubString{ASCIIString}["CCGAGTGTCTATACTTATA"]
TCCATAATCGGAGACATGT	SubString{ASCIIString}["CCATAATCGGAGACATGTT"]
AAAAGTTCATGGTACCTTA	SubString{ASCIIString}["AAAGTTCATGGTACCTTAG"]
TGGGTTGCGTTCGACAGTT	SubString{ASCIIString}["GGGTTGCGTTCGACAGTTA"]
ACAGCGAACGACGCGGGCT	SubString{ASCIIString}["CAGCGAACGACGCGGGCTT"]
TTTCCCCTACGTTTGCCGC	SubString{ASCIIString}["TTCCCCTACGTTTGCCGCA"]
TCTAGTTTTCGCAGCTGGA	SubString{ASCIIString}["CTAGTTTTCGCAGCTGGAA"]
TGTTCCTACTCGCCCTATA	SubString{ASCIIString}["GTTCCTACTCGCCCTATAT"]
GTATTCCGGCATTCGCCAC	SubString{ASCIIString}["TATTCCGGCATTCGCCACC"]
ATTCAGTGTGAGGCTTATC	SubString{ASCIIString}["TTCAGTGTGAGGCTTATCA"]
GGGCATGTAGGAGGAGAAG	SubString{ASCIIString}["GGCATGTAGGAGGAGAAGT"]
TGACTCGTGTCGCTAAGCA	SubString{ASCIIString}["GACTCGTGTCGCTAAGCAA"]
AATAAGGTCCCCGTTGTTG	SubString{ASCIIString}["ATAAGGTCCCCGTTGTTGT"]
CAACGCCCATTTTCTTCGG	SubString{ASCIIString}["AACGCCCATTTTCTTCGGT"]
AATCGGGAGGTGCTGGCTA	SubString{ASCIIString}["ATCGGGAGGTGCTGGCTAG"]
GTCCGAAAATCGCCAAATG	SubString{ASCIIString}["TCCGAAAATCGCCAAATGG"]
TGGAGGGGTCATTACAGCC	SubString{ASCIIString}["GGAGGGGTCATTACAGCCG"]
CTATATGCAGTGCGTAGGG	SubString{ASCIIString}["TATATGCAGTGCGTAGGGG"]
GCTCGCGCCCACATCTAGG	SubString{ASCIIString}["CTCGCGCCCACATCTAGGG"]
GGCACCCACGGCATGCCCT	SubString{ASCIIString}["GCACCCACGGCATGCCCTT"]
AGGCGTGATCTGATGGGTT	SubString{ASCIIString}["GGCGTGATCTGATGGGTTT"]
CGACTTATCATAGAGGCTT	SubString{ASCIIString}["GACTTATCATAGAGGCTTA"]
ACGGCATTGTCTAGTTTTC	SubString{ASCIIString}["CGGCATTGTCTAGTTTTCG"]
TATACGGGTCTGCATAGTT	SubString{ASCIIString}["ATACGGGTCTGCATAGTTG"]
CTCGCCCTCTCTGGTTCCG	SubString{ASCIIString}["TCGCCCTCTCTGGTTCCGT"]
GCCCTACCCGGTCCGAAAA	SubString{ASCIIString}["CCCTACCCGGTCCGAAAAT"]
ATCGCCAAATACGATTATC	SubString{ASCIIString}["TCGCCAAATACGATTATCA"]
CCTACGTTTGCCGCATGGG	SubString{ASCIIString}["CTACGTTTGCCGCATGGGG"]
ATGCAGTGCGTAGGGGGTA	SubString{ASCIIString}["TGCAGTGCGTAGGGGGTAT"]
AAACCTGAATCGGGAGGTG	SubString{ASCIIString}["AACCTGAATCGGGAGGTGC"]
ATTGTCTAGTTTTCGCAGC	SubString{ASCIIString}["TTGTCTAGTTTTCGCAGCT"]
TGGAGTACAAAAATGTTGG	SubString{ASCIIString}["GGAGTACAAAAATGTTGGA"]
ATACGTCCGAAAATCGCCA	SubString{ASCIIString}["TACGTCCGAAAATCGCCAA"]
GTCCGAAAATCGCCAAATT	SubString{ASCIIString}["TCCGAAAATCGCCAAATTG"]
ATAATACAGATTCGTAGAC	SubString{ASCIIString}["TAATACAGATTCGTAGACG"]
GCCGATATACGGGTCTGCA	SubString{ASCIIString}["CCGATATACGGGTCTGCAT"]
TTGTCTAGTTTTCGCAGCT	SubString{ASCIIString}["TGTCTAGTTTTCGCAGCTG"]
CCTTTATATGAGCACGGAA	SubString{ASCIIString}["CTTTATATGAGCACGGAAA"]
TAAGTTTAAGGTAATCGCC	SubString{ASCIIString}["AAGTTTAAGGTAATCGCCC"]
CAGTGTGCATACAGCCCTA	SubString{ASCIIString}["AGTGTGCATACAGCCCTAA"]
CAAATTGTTCGCGGGCATG	SubString{ASCIIString}["AAATTGTTCGCGGGCATGT"]
TAATCGGAGACATGTTACC	SubString{ASCIIString}["AATCGGAGACATGTTACCA"]
TAATAATACAGATTCGTAG	SubString{ASCIIString}["AATAATACAGATTCGTAGA"]
CTTGAGACCGCCAGTTAGT	SubString{ASCIIString}["TTGAGACCGCCAGTTAGTT"]
GGAGTACAAAAATGTTGGA	SubString{ASCIIString}["GAGTACAAAAATGTTGGAC"]
AAAATCGCCAAATACGATT	SubString{ASCIIString}["AAATCGCCAAATACGATTA"]
TACGGGTCTGCATAGTTGA	SubString{ASCIIString}["ACGGGTCTGCATAGTTGAA"]
CGTGTCGCTAAGCAACATT	SubString{ASCIIString}["GTGTCGCTAAGCAACATTA"]
TGTTCGGCCGATTAAGTAA	SubString{ASCIIString}["GTTCGGCCGATTAAGTAAG"]
AGCCCTAATAGCTGACAGG	SubString{ASCIIString}["GCCCTAATAGCTGACAGGG"]
TACTTTGATTCCGTGACTC	SubString{ASCIIString}["ACTTTGATTCCGTGACTCG"]
GTTCTAAGCGACTTATCAT	SubString{ASCIIString}["TTCTAAGCGACTTATCATA"]
TACGTTTGCCGCATGGGGA	SubString{ASCIIString}["ACGTTTGCCGCATGGGGAC"]
TGCGGGTCGAGTCGCCGGT	SubString{ASCIIString}["GCGGGTCGAGTCGCCGGTA"]
CTGCAACCCCGGTTCGCTT	SubString{ASCIIString}["TGCAACCCCGGTTCGCTTG"]
AATCCGGTACAGGTTAATG	SubString{ASCIIString}["ATCCGGTACAGGTTAATGT"]
ATCTCCCTGGCCCACCTGT	SubString{ASCIIString}["TCTCCCTGGCCCACCTGTT"]
CGGTTCTACGTGTCAGCAA	SubString{ASCIIString}["GGTTCTACGTGTCAGCAAT"]
CCGTGTTTTGATTATATCG	SubString{ASCIIString}["CGTGTTTTGATTATATCGG"]
GCGGTCAACTGGGAAGTCG	SubString{ASCIIString}["CGGTCAACTGGGAAGTCGT"]
CGGCATTGTCTAGTTTTCG	SubString{ASCIIString}["GGCATTGTCTAGTTTTCGC"]
GAAATGATCACCCCGTGTT	SubString{ASCIIString}["AAATGATCACCCCGTGTTG"]
GCTCAGGCGTGATCTGATG	SubString{ASCIIString}["CTCAGGCGTGATCTGATGG"]
TCCTTTAGTCTTTCCGGAA	SubString{ASCIIString}["CCTTTAGTCTTTCCGGAAG"]
ATACTGGACATGGCACCTT	SubString{ASCIIString}["TACTGGACATGGCACCTTT"]
ATCCGTGGGCAACTTGTTA	SubString{ASCIIString}["TCCGTGGGCAACTTGTTAT"]
TATATGCAGTGCGTAGGGG	SubString{ASCIIString}["ATATGCAGTGCGTAGGGGG"]
GCACCTTTATTATCGGCAA	SubString{ASCIIString}["CACCTTTATTATCGGCAAT"]
GAAAATCGCCAAATACGAT	SubString{ASCIIString}["AAAATCGCCAAATACGATT"]
GAACTTATTTTGGCCAATG	SubString{ASCIIString}["AACTTATTTTGGCCAATGC"]
GTTTGCATTCCACAGATGG	SubString{ASCIIString}["TTTGCATTCCACAGATGGC"]
CATTTTCCCCTACGTTTGC	SubString{ASCIIString}["ATTTTCCCCTACGTTTGCC"]
TGCAACCCCGGTTCGCTTG	SubString{ASCIIString}["GCAACCCCGGTTCGCTTGT"]
CAACAGGCATGTAGGAGGA	SubString{ASCIIString}["AACAGGCATGTAGGAGGAG"]
AGGAGTGTCCACCTATGAC	SubString{ASCIIString}["GGAGTGTCCACCTATGACC"]
GACACCACAACAAGAGAAA	SubString{ASCIIString}["ACACCACAACAAGAGAAAC"]
CGCCAAATTGTTCGCGGGC	SubString{ASCIIString}["GCCAAATTGTTCGCGGGCA"]
GCGCGCGGTTGGGGGCGCT	SubString{ASCIIString}["CGCGCGGTTGGGGGCGCTT"]
CCTAGACTCCGAGCAGCGA	SubString{ASCIIString}["CTAGACTCCGAGCAGCGAT"]
AAATCACCAACAGGCATGT	SubString{ASCIIString}["AATCACCAACAGGCATGTA"]
AACACGCTGAGCAAAATAT	SubString{ASCIIString}["ACACGCTGAGCAAAATATG"]
AAGTTTAAGGTAATCGCCC	SubString{ASCIIString}["AGTTTAAGGTAATCGCCCG"]
ATGTTTTCAATTGATCCTC	SubString{ASCIIString}["TGTTTTCAATTGATCCTCT"]
CCGTCTCAGGAAGTCTACG	SubString{ASCIIString}["CGTCTCAGGAAGTCTACGT"]
TTCCGTGACTCGTGTCGCT	SubString{ASCIIString}["TCCGTGACTCGTGTCGCTA"]
GTGGAACTTATTTTGGCCA	SubString{ASCIIString}["TGGAACTTATTTTGGCCAA"]
GTTCGCTTGTGCGTTCACA	SubString{ASCIIString}["TTCGCTTGTGCGTTCACAT"]
CCAGTTAGTTTCGCGCTTA	SubString{ASCIIString}["CAGTTAGTTTCGCGCTTAC"]
ACAGACGCTTGAAAAGATG	SubString{ASCIIString}["CAGACGCTTGAAAAGATGC"]
TCGCCAAATACGATTATCA	SubString{ASCIIString}["CGCCAAATACGATTATCAC"]
TTATCGGCAATGCAGCACC	SubString{ASCIIString}["TATCGGCAATGCAGCACCA"]
CCAGACAGACGCTTGAAAA	SubString{ASCIIString}["CAGACAGACGCTTGAAAAG"]
AACCGCCCCTGGCGAACCT	SubString{ASCIIString}["ACCGCCCCTGGCGAACCTA"]
CAGTTAGCAACAAAAAGAA	SubString{ASCIIString}["AGTTAGCAACAAAAAGAAG"]
AGTTTAAGGTAATCGCCCG	SubString{ASCIIString}["GTTTAAGGTAATCGCCCGA"]
AAAATCGCCAAATGGCAAA	SubString{ASCIIString}["AAATCGCCAAATGGCAAAA"]
TGAATCCGGTACAGGTTAA	SubString{ASCIIString}["GAATCCGGTACAGGTTAAT"]
GAAGTAACCGCTTGCGACA	SubString{ASCIIString}["AAGTAACCGCTTGCGACAA"]
ACGTTTGCCGCATGGGGAC	SubString{ASCIIString}["CGTTTGCCGCATGGGGACA"]
GCAGTGCGTAGGGGGTATG	SubString{ASCIIString}["CAGTGCGTAGGGGGTATGT"]
TCACATGTAGGAGGAGAAG	SubString{ASCIIString}["CACATGTAGGAGGAGAAGT"]
GTTGAATCCGGTACAGGTT	SubString{ASCIIString}["TTGAATCCGGTACAGGTTA"]
AATGATCACCCCGTGTTGC	SubString{ASCIIString}["ATGATCACCCCGTGTTGCT"]
GTCGTGCACAGTAGTCCTC	SubString{ASCIIString}["TCGTGCACAGTAGTCCTCC"]
GAAGTCTACGTTAGGAGTG	SubString{ASCIIString}["AAGTCTACGTTAGGAGTGT"]
ACCCCGTGTTGCTGCGGGT	SubString{ASCIIString}["CCCCGTGTTGCTGCGGGTC"]
ATCCGGTACAGGTTAATGT	SubString{ASCIIString}["TCCGGTACAGGTTAATGTG"]
AGAATACTTTGATTCCGTG	SubString{ASCIIString}["GAATACTTTGATTCCGTGA"]
TCAGGAAGTCTACGTTAGG	SubString{ASCIIString}["CAGGAAGTCTACGTTAGGA"]
GTTGGGGGCGCTTTCAAAG	SubString{ASCIIString}["TTGGGGGCGCTTTCAAAGC"]
AACCTCTGCACTGTGGTTG	SubString{ASCIIString}["ACCTCTGCACTGTGGTTGC"]
TCTCAGGAAGTCTACGTTA	SubString{ASCIIString}["CTCAGGAAGTCTACGTTAG"]
GTAGGCGGAGTTCTAAGCG	SubString{ASCIIString}["TAGGCGGAGTTCTAAGCGA"]
ACAGATTCGTAGACGTTCA	SubString{ASCIIString}["CAGATTCGTAGACGTTCAA"]
TAGTTCTGACCTAATATAG	SubString{ASCIIString}["AGTTCTGACCTAATATAGT"]
AAGGGTGTGGAGCACCTCG	SubString{ASCIIString}["AGGGTGTGGAGCACCTCGC"]
CGCCATCTACGGCATTGTC	SubString{ASCIIString}["GCCATCTACGGCATTGTCT"]
CACGGCATGCCCTTTTGGC	SubString{ASCIIString}["ACGGCATGCCCTTTTGGCG"]
GTCTAAGCGCTACCGTCGT	SubString{ASCIIString}["TCTAAGCGCTACCGTCGTC"]
GCAGCCAACTAGTTCTGAC	SubString{ASCIIString}["CAGCCAACTAGTTCTGACC"]
TTATCTGCTTTCACCACAG	SubString{ASCIIString}["TATCTGCTTTCACCACAGC"]
TGCATACAGCCCTAATAGC	SubString{ASCIIString}["GCATACAGCCCTAATAGCT"]
TTTGGCGGACTCCTGCCTT	SubString{ASCIIString}["TTGGCGGACTCCTGCCTTC"]
CATGGTACCTTAGTCCGAA	SubString{ASCIIString}["ATGGTACCTTAGTCCGAAA"]
CCCCTAGACTCCGAGCAGC	SubString{ASCIIString}["CCCTAGACTCCGAGCAGCG"]
GGTATTCCGGCATTCGCCA	SubString{ASCIIString}["GTATTCCGGCATTCGCCAC"]
GCTGCCACACAGCCACAGA	SubString{ASCIIString}["CTGCCACACAGCCACAGAC"]
CTTGCGACAAGGTCCTAGG	SubString{ASCIIString}["TTGCGACAAGGTCCTAGGA"]
CAGGGCCTGTTCGCAGCCC	SubString{ASCIIString}["AGGGCCTGTTCGCAGCCCT"]
CCTTTTGGCGGACTCCTGC	SubString{ASCIIString}["CTTTTGGCGGACTCCTGCC"]
GGTCCTAGGACCGTCTCAG	SubString{ASCIIString}["GTCCTAGGACCGTCTCAGG"]
TGGCGCGCGGTTGGGGGCG	SubString{ASCIIString}["GGCGCGCGGTTGGGGGCGC"]
TACTGCGAATGTTTTCAAT	SubString{ASCIIString}["ACTGCGAATGTTTTCAATT"]
TTGTGCGTTCACATGGTCA	SubString{ASCIIString}["TGTGCGTTCACATGGTCAT"]
GTAAGTTTAAGGTAATCGC	SubString{ASCIIString}["TAAGTTTAAGGTAATCGCC"]
ATCTATACGTCCGAAAATC	SubString{ASCIIString}["TCTATACGTCCGAAAATCG"]
TTAATGTGCGTACTGCGAA	SubString{ASCIIString}["TAATGTGCGTACTGCGAAT"]
AAGGCAGTTCATCTCCCTG	SubString{ASCIIString}["AGGCAGTTCATCTCCCTGG"]
GGCCAGAACGGCCCCTAGA	SubString{ASCIIString}["GCCAGAACGGCCCCTAGAC"]
CTAGTTCTGACCTAATATA	SubString{ASCIIString}["TAGTTCTGACCTAATATAG"]
AAACACGCTGAGCAAAATA	SubString{ASCIIString}["AACACGCTGAGCAAAATAT"]
ATGACCTGGGTTGCGTTCG	SubString{ASCIIString}["TGACCTGGGTTGCGTTCGA"]
GTTGTTGTGGTCGTGTTTT	SubString{ASCIIString}["TTGTTGTGGTCGTGTTTTG"]
TTCCAGACAGACGCTTGAA	SubString{ASCIIString}["TCCAGACAGACGCTTGAAA"]
TCGCCCGAGTGTCTATACT	SubString{ASCIIString}["CGCCCGAGTGTCTATACTT"]
ATCTAGGGACTCATTCAAT	SubString{ASCIIString}["TCTAGGGACTCATTCAATT"]
CTGCACTGTGGTTGCAAAA	SubString{ASCIIString}["TGCACTGTGGTTGCAAAAT"]
TCCGGAAGATTTTCCCTGT	SubString{ASCIIString}["CCGGAAGATTTTCCCTGTT"]
GGAGGAGAAGTAACCGCTT	SubString{ASCIIString}["GAGGAGAAGTAACCGCTTG"]
ACTCATTCAATTCTTAGAT	SubString{ASCIIString}["CTCATTCAATTCTTAGATA"]
ACCAACAGGCATGTAGGAG	SubString{ASCIIString}["CCAACAGGCATGTAGGAGG"]
TACCTGAATGGATGTCCGA	SubString{ASCIIString}["ACCTGAATGGATGTCCGAA"]
ACAACAAGAGAAACACGCT	SubString{ASCIIString}["CAACAAGAGAAACACGCTG"]
CGTCGTGAGGCTAGATTTA	SubString{ASCIIString}["GTCGTGAGGCTAGATTTAC"]
TAGTTTTCGCAGCTGGAAG	SubString{ASCIIString}["AGTTTTCGCAGCTGGAAGT"]
ACCCTATCCGTGGGCAACT	SubString{ASCIIString}["CCCTATCCGTGGGCAACTT"]
AGTAATAAGGTCCCCGTTG	SubString{ASCIIString}["GTAATAAGGTCCCCGTTGT"]
TCTAGCAGTGTTTAGGCCT	SubString{ASCIIString}["CTAGCAGTGTTTAGGCCTC"]
AAGATTTTCCCTGTTCGGC	SubString{ASCIIString}["AGATTTTCCCTGTTCGGCC"]
TGAATGGATGTCCGAAAAT	SubString{ASCIIString}["GAATGGATGTCCGAAAATC"]
ACCTGAATCGGGAGGTGCT	SubString{ASCIIString}["CCTGAATCGGGAGGTGCTG"]
CCCCGTGTTGCTGCGGGTC	SubString{ASCIIString}["CCCGTGTTGCTGCGGGTCG"]
CTCGTGTCGCTAAGCAACA	SubString{ASCIIString}["TCGTGTCGCTAAGCAACAT"]
TACCAGATCCGAGGATCTG	SubString{ASCIIString}["ACCAGATCCGAGGATCTGG"]
AAGCGGTTTCTGGCGCGCG	SubString{ASCIIString}["AGCGGTTTCTGGCGCGCGG"]
TCGTGCACAGTAGTCCTCC	SubString{ASCIIString}["CGTGCACAGTAGTCCTCCA"]
TTGACACGAGATACATTCA	SubString{ASCIIString}["TGACACGAGATACATTCAG"]
CGATTAAGTAAGTTTAAGG	SubString{ASCIIString}["GATTAAGTAAGTTTAAGGT"]
AAAATCGCCAAATTGTTCG	SubString{ASCIIString}["AAATCGCCAAATTGTTCGC"]
TAGGAGGAGAAGTAACCAT	SubString{ASCIIString}["AGGAGGAGAAGTAACCATG"]
CCTTATGAGTGTATGCTGC	SubString{ASCIIString}["CTTATGAGTGTATGCTGCC"]
ACATTATCAAATCCGGGCA	SubString{ASCIIString}["CATTATCAAATCCGGGCAG"]
TAGCTGACAGGGGCAGTCA	SubString{ASCIIString}["AGCTGACAGGGGCAGTCAT"]
CAATTGATCCTCTTTTAAT	SubString{ASCIIString}["AATTGATCCTCTTTTAATA"]
GGAGGGGTCATTACAGCCG	SubString{ASCIIString}["GAGGGGTCATTACAGCCGA"]
CGCGGTTGGGGGCGCTTTC	SubString{ASCIIString}["GCGGTTGGGGGCGCTTTCA"]
CTGGACATGGCACCTTTAT	SubString{ASCIIString}["TGGACATGGCACCTTTATT"]
GACTCATTCAATTCTTAGA	SubString{ASCIIString}["ACTCATTCAATTCTTAGAT"]
GCATGCCCTTTTGGCGGAC	SubString{ASCIIString}["CATGCCCTTTTGGCGGACT"]
ATCATTCCCTTTATATGAG	SubString{ASCIIString}["TCATTCCCTTTATATGAGC"]
CCAGGGCCTGTTCGCAGCC	SubString{ASCIIString}["CAGGGCCTGTTCGCAGCCC"]
TCATGACCAGGGCCTGTTC	SubString{ASCIIString}["CATGACCAGGGCCTGTTCG"]
CAGGAAGTCTACGTTAGGA	SubString{ASCIIString}["AGGAAGTCTACGTTAGGAG"]
TCGTCCTTGTCATGGGTTC	SubString{ASCIIString}["CGTCCTTGTCATGGGTTCA"]
AAATGGCAAAAAGCCATGT	SubString{ASCIIString}["AATGGCAAAAAGCCATGTA"]
AGCAATAGTCTAAGCGCTA	SubString{ASCIIString}["GCAATAGTCTAAGCGCTAC"]
CAACAAGAGAAACACGCTG	SubString{ASCIIString}["AACAAGAGAAACACGCTGA"]
GGAGATGCCGCCATCTACG	SubString{ASCIIString}["GAGATGCCGCCATCTACGG"]
AATCGCCCGAGTGTCTATA	SubString{ASCIIString}["ATCGCCCGAGTGTCTATAC"]
GAGGAGAAGTAACCATGCC	SubString{ASCIIString}["AGGAGAAGTAACCATGCCG"]
TGTCCACCTATGACCTTCC	SubString{ASCIIString}["GTCCACCTATGACCTTCCA"]
ACCCTGCGCGGTCAACTGG	SubString{ASCIIString}["CCCTGCGCGGTCAACTGGG"]
GAGCAGCGATACTTTCACA	SubString{ASCIIString}["AGCAGCGATACTTTCACAC"]
GGTTCATGACCAGGGCCTG	SubString{ASCIIString}["GTTCATGACCAGGGCCTGT"]
CCCTGCGCGGTCAACTGGG	SubString{ASCIIString}["CCTGCGCGGTCAACTGGGA"]
GCGCATCATTCCCTTTATA	SubString{ASCIIString}["CGCATCATTCCCTTTATAT"]
CTCCCTGGCCCACCTGTTT	SubString{ASCIIString}["TCCCTGGCCCACCTGTTTG"]
CATGAGAGCTGACAGCGCG	SubString{ASCIIString}["ATGAGAGCTGACAGCGCGT"]
GTCCTTTAGTCTTTCCGGA	SubString{ASCIIString}["TCCTTTAGTCTTTCCGGAA"]
ATCACATGTAGGAGGAGAA	SubString{ASCIIString}["TCACATGTAGGAGGAGAAG"]
ACTGGGAAGTCGTGCACAG	SubString{ASCIIString}["CTGGGAAGTCGTGCACAGT"]
TCCGTGGGCAACTTGTTAT	SubString{ASCIIString}["CCGTGGGCAACTTGTTATA"]
GAAGTAACATCTTATCTGC	SubString{ASCIIString}["AAGTAACATCTTATCTGCT"]
GCAACAAAAAGAAGAGAAT	SubString{ASCIIString}["CAACAAAAAGAAGAGAATA"]
TCTACGGCATTGTCTAGTT	SubString{ASCIIString}["CTACGGCATTGTCTAGTTT"]
AAATCGCCAAATGGCAAAA	SubString{ASCIIString}["AATCGCCAAATGGCAAAAA"]
TACGATTATCACATGTAGG	SubString{ASCIIString}["ACGATTATCACATGTAGGA"]
ACCGTCTCAGGAAGTCTAC	SubString{ASCIIString}["CCGTCTCAGGAAGTCTACG"]
AGTCCGGACCCTGCAACCC	SubString{ASCIIString}["GTCCGGACCCTGCAACCCC"]
GACGTTCAACTTTTGGTGA	SubString{ASCIIString}["ACGTTCAACTTTTGGTGAC"]
AGATAATCGCGCGCAAGTT	SubString{ASCIIString}["GATAATCGCGCGCAAGTTT"]
TTTAATAATACAGATTCGT	SubString{ASCIIString}["TTAATAATACAGATTCGTA"]
CCGGAAGATTTTCCCTGTT	SubString{ASCIIString}["CGGAAGATTTTCCCTGTTC"]
CATCTAAATCGTGCAACCA	SubString{ASCIIString}["ATCTAAATCGTGCAACCAA"]
TTTAGACAGATGTCAAGCA	SubString{ASCIIString}["TTAGACAGATGTCAAGCAC"]
AGGATCTGGTGGCTAGTAA	SubString{ASCIIString}["GGATCTGGTGGCTAGTAAA"]
CCGAGCAGCGATACTTTCA	SubString{ASCIIString}["CGAGCAGCGATACTTTCAC"]
AGCGTGAAAAATTCACGGT	SubString{ASCIIString}["GCGTGAAAAATTCACGGTA"]
TTACTAAAGCTAGCCATGA	SubString{ASCIIString}["TACTAAAGCTAGCCATGAG"]
GCCGAACCCACTAGTCCGG	SubString{ASCIIString}["CCGAACCCACTAGTCCGGA"]
CCGGTACAGGTTAATGTGC	SubString{ASCIIString}["CGGTACAGGTTAATGTGCG"]
GTCCATCTAAATCGTGCAA	SubString{ASCIIString}["TCCATCTAAATCGTGCAAC"]
GAATCGGGAGGTGCTGGCT	SubString{ASCIIString}["AATCGGGAGGTGCTGGCTA"]
CGGGCTTGCGCATCATTCC	SubString{ASCIIString}["GGGCTTGCGCATCATTCCC"]
TCGCCCTCTCTGGTTCCGT	SubString{ASCIIString}["CGCCCTCTCTGGTTCCGTA"]
TATTTTGGCCAATGCAAGT	SubString{ASCIIString}["ATTTTGGCCAATGCAAGTA"]
TCGCTTGTGCGTTCACATG	SubString{ASCIIString}["CGCTTGTGCGTTCACATGG"]
TCTTCATGACCTGGGTTGC	SubString{ASCIIString}["CTTCATGACCTGGGTTGCG"]
CTCTATCGGCTCTTCATGA	SubString{ASCIIString}["TCTATCGGCTCTTCATGAC"]
TGTACCCTGCGCGGTCAAC	SubString{ASCIIString}["GTACCCTGCGCGGTCAACT"]
TTTTCCCTGTTCGGCCGAT	SubString{ASCIIString}["TTTCCCTGTTCGGCCGATT"]
GTTTAAGGTAATCGCCCGA	SubString{ASCIIString}["TTTAAGGTAATCGCCCGAG"]
AGGCTTATCAACGCCCATT	SubString{ASCIIString}["GGCTTATCAACGCCCATTT"]
CGACAAGGTCCTAGGACCG	SubString{ASCIIString}["GACAAGGTCCTAGGACCGT"]
AAAATCGCCAAATCACCAA	SubString{ASCIIString}["AAATCGCCAAATCACCAAC"]
GACCGCCAGTTAGTTTCGC	SubString{ASCIIString}["ACCGCCAGTTAGTTTCGCG"]
TTGGTGACTTAACAAGAAA	SubString{ASCIIString}["TGGTGACTTAACAAGAAAT"]
AATGGCAAAAAGCCATGTA	SubString{ASCIIString}["ATGGCAAAAAGCCATGTAG"]
TCGTAGACGTTCAACTTTT	SubString{ASCIIString}["CGTAGACGTTCAACTTTTG"]
ATGATCACCCCGTGTTGCT	SubString{ASCIIString}["TGATCACCCCGTGTTGCTG"]
TCTAGGGACTCATTCAATT	SubString{ASCIIString}["CTAGGGACTCATTCAATTC"]
TTTGATTCCGTGACTCGTG	SubString{ASCIIString}["TTGATTCCGTGACTCGTGT"]
CCGCCCCTGGCGAACCTAG	SubString{ASCIIString}["CGCCCCTGGCGAACCTAGG"]
GGCTGAATGTTCCTACTCG	SubString{ASCIIString}["GCTGAATGTTCCTACTCGC"]
GCTAGCCATGAGAGCTGAC	SubString{ASCIIString}["CTAGCCATGAGAGCTGACA"]
TCATTTAGACAGATGTCAA	SubString{ASCIIString}["CATTTAGACAGATGTCAAG"]
TGCCGACCCCAGCTCGCGC	SubString{ASCIIString}["GCCGACCCCAGCTCGCGCC"]
ACGCCCATTTTCTTCGGTA	SubString{ASCIIString}["CGCCCATTTTCTTCGGTAT"]
GAATTGAGGCCGAACCCAC	SubString{ASCIIString}["AATTGAGGCCGAACCCACT"]
TAGGGGGTATGTGGAACTT	SubString{ASCIIString}["AGGGGGTATGTGGAACTTA"]
CCCGGTTCGCTTGTGCGTT	SubString{ASCIIString}["CCGGTTCGCTTGTGCGTTC"]
GGTTGAAGACATTTTCCCC	SubString{ASCIIString}["GTTGAAGACATTTTCCCCT"]
AGACAGATGTCAAGCACCC	SubString{ASCIIString}["GACAGATGTCAAGCACCCA"]
GGGGTATGTGGAACTTATT	SubString{ASCIIString}["GGGTATGTGGAACTTATTT"]
TGACACGAGATACATTCAG	SubString{ASCIIString}["GACACGAGATACATTCAGT"]
TATATTCTCGTCGTGAGGC	SubString{ASCIIString}["ATATTCTCGTCGTGAGGCT"]
ATGGTACCTTAGTCCGAAA	SubString{ASCIIString}["TGGTACCTTAGTCCGAAAA"]
GAGGTGCTGGCTAGCGTGA	SubString{ASCIIString}["AGGTGCTGGCTAGCGTGAA"]
CACCAGCCAGTTCTCCTTA	SubString{ASCIIString}["ACCAGCCAGTTCTCCTTAC"]
TGCAGTAGGCGGAGTTCTA	SubString{ASCIIString}["GCAGTAGGCGGAGTTCTAA"]
TCTAAATCGTGCAACCAAG	SubString{ASCIIString}["CTAAATCGTGCAACCAAGT"]
GGAAGGCAGTTCATCTCCC	SubString{ASCIIString}["GAAGGCAGTTCATCTCCCT"]
GAAGACATTTTCCCCTACG	SubString{ASCIIString}["AAGACATTTTCCCCTACGT"]
TTCATCTCCCTGGCCCACC	SubString{ASCIIString}["TCATCTCCCTGGCCCACCT"]
GTGGAGTACAAAAATGTTG	SubString{ASCIIString}["TGGAGTACAAAAATGTTGG"]
CATACAGCCCTAATAGCTG	SubString{ASCIIString}["ATACAGCCCTAATAGCTGA"]
TGGTTCCGTAGCCGCTCTA	SubString{ASCIIString}["GGTTCCGTAGCCGCTCTAT"]
TAGGACCGTCTCAGGAAGT	SubString{ASCIIString}["AGGACCGTCTCAGGAAGTC"]
TACTTTCACACCGTGTTTT	SubString{ASCIIString}["ACTTTCACACCGTGTTTTG"]
GTTCATGACCAGGGCCTGT	SubString{ASCIIString}["TTCATGACCAGGGCCTGTT"]
AGGAGGAGAAGTAACATCT	SubString{ASCIIString}["GGAGGAGAAGTAACATCTT"]
CCGAGGATCTGGTGGCTAG	SubString{ASCIIString}["CGAGGATCTGGTGGCTAGT"]
TCTGCATAGTTGAATCCGG	SubString{ASCIIString}["CTGCATAGTTGAATCCGGT"]
TACTTATATTCTCGTCGTG	SubString{ASCIIString}["ACTTATATTCTCGTCGTGA"]
TAGCAACAAAAAGAAGAGA	SubString{ASCIIString}["AGCAACAAAAAGAAGAGAA"]
TGTGGAACTTATTTTGGCC	SubString{ASCIIString}["GTGGAACTTATTTTGGCCA"]
CCTGTTTGAAAAGTTCATG	SubString{ASCIIString}["CTGTTTGAAAAGTTCATGG"]
AATCCGGGCAGCCAACTAG	SubString{ASCIIString}["ATCCGGGCAGCCAACTAGT"]
GCAGTGTTTAGGCCTCGAA	SubString{ASCIIString}["CAGTGTTTAGGCCTCGAAA"]
GTTGTGGTCGTGTTTTGGG	SubString{ASCIIString}["TTGTGGTCGTGTTTTGGGG"]
AATGTTTTCAATTGATCCT	SubString{ASCIIString}["ATGTTTTCAATTGATCCTC"]
CCAAATACGATTATCACAT	SubString{ASCIIString}["CAAATACGATTATCACATG"]
TATTCCGGCATTCGCCACC	SubString{ASCIIString}["ATTCCGGCATTCGCCACCC"]
TATCACATGTAGGAGGAGA	SubString{ASCIIString}["ATCACATGTAGGAGGAGAA"]
TCCTACTCGCCCTATATGC	SubString{ASCIIString}["CCTACTCGCCCTATATGCA"]
GTACCTTAGTCCGAAAATC	SubString{ASCIIString}["TACCTTAGTCCGAAAATCG"]
AACTTGTTATAGTCCTTTA	SubString{ASCIIString}["ACTTGTTATAGTCCTTTAG"]
GCGCAAGTTTGCATTCCAC	SubString{ASCIIString}["CGCAAGTTTGCATTCCACA"]
TCAAATCCGGGCAGCCAAC	SubString{ASCIIString}["CAAATCCGGGCAGCCAACT"]
TGCGCATCATTCCCTTTAT	SubString{ASCIIString}["GCGCATCATTCCCTTTATA"]
GCCCTATATGCAGTGCGTA	SubString{ASCIIString}["CCCTATATGCAGTGCGTAG"]
CTACGTGTCAGCAATAGTC	SubString{ASCIIString}["TACGTGTCAGCAATAGTCT"]
GCTGACAGCGCGTGGGAGA	SubString{ASCIIString}["CTGACAGCGCGTGGGAGAT"]
AGAAACACGCTGAGCAAAA	SubString{ASCIIString}["GAAACACGCTGAGCAAAAT"]
CCGTGACTCGTGTCGCTAA	SubString{ASCIIString}["CGTGACTCGTGTCGCTAAG"]
GCAGTTCATCTCCCTGGCC	SubString{ASCIIString}["CAGTTCATCTCCCTGGCCC"]
GGCGTGATCTGATGGGTTT	SubString{ASCIIString}["GCGTGATCTGATGGGTTTG"]
TTTGACACGAGATACATTC	SubString{ASCIIString}["TTGACACGAGATACATTCA"]
TCGCGCGGTTCTACGTGTC	SubString{ASCIIString}["CGCGCGGTTCTACGTGTCA"]
CGCCAAATCACCAACAGGC	SubString{ASCIIString}["GCCAAATCACCAACAGGCA"]
AACCAATCTATACGTCCGA	SubString{ASCIIString}["ACCAATCTATACGTCCGAA"]
GGGGGTATGTGGAACTTAT	SubString{ASCIIString}["GGGGTATGTGGAACTTATT"]
TTTAAACAGTGTGCATACA	SubString{ASCIIString}["TTAAACAGTGTGCATACAG"]
CCTTGTCATGGGTTCATGA	SubString{ASCIIString}["CTTGTCATGGGTTCATGAC"]
ATATCGGTTGAAGACATTT	SubString{ASCIIString}["TATCGGTTGAAGACATTTT"]
GGGAAGTCGTGCACAGTAG	SubString{ASCIIString}["GGAAGTCGTGCACAGTAGT"]
GCCGACCCCAGCTCGCGCC	SubString{ASCIIString}["CCGACCCCAGCTCGCGCCC"]
GAGGCTTATCAACGCCCAT	SubString{ASCIIString}["AGGCTTATCAACGCCCATT"]
GCAAGTAATAAGGTCCCCG	SubString{ASCIIString}["CAAGTAATAAGGTCCCCGT"]
TCTAAGCGACTTATCATAG	SubString{ASCIIString}["CTAAGCGACTTATCATAGA"]
TTTCCGGAAGGCAGTTCAT	SubString{ASCIIString}["TTCCGGAAGGCAGTTCATC"]
AGTAGTCCTCCATAATCGG	SubString{ASCIIString}["GTAGTCCTCCATAATCGGA"]
CTAGCCATGAGAGCTGACA	SubString{ASCIIString}["TAGCCATGAGAGCTGACAG"]
TTCAACTTTTGGTGACTTA	SubString{ASCIIString}["TCAACTTTTGGTGACTTAA"]
GATGTCCGAAAATCGCCAA	SubString{ASCIIString}["ATGTCCGAAAATCGCCAAA"]
TCATACTGGACATGGCACC	SubString{ASCIIString}["CATACTGGACATGGCACCT"]
CCGCCATCTACGGCATTGT	SubString{ASCIIString}["CGCCATCTACGGCATTGTC"]
GTACAAAAATGTTGGACCC	SubString{ASCIIString}["TACAAAAATGTTGGACCCT"]
GGGGCCTTATGAGTGTATG	SubString{ASCIIString}["GGGCCTTATGAGTGTATGC"]
CCAACCTCTGCACTGTGGT	SubString{ASCIIString}["CAACCTCTGCACTGTGGTT"]
CGCCCTCTCTGGTTCCGTA	SubString{ASCIIString}["GCCCTCTCTGGTTCCGTAG"]
CGTTCGACAGTTAGCAACA	SubString{ASCIIString}["GTTCGACAGTTAGCAACAA"]
ATGGATGTCCGAAAATCGC	SubString{ASCIIString}["TGGATGTCCGAAAATCGCC"]
CGCTACCGTCGTCCTTGTC	SubString{ASCIIString}["GCTACCGTCGTCCTTGTCA"]
GAATACTTTGATTCCGTGA	SubString{ASCIIString}["AATACTTTGATTCCGTGAC"]
TAATATAGTCCGGAAGATT	SubString{ASCIIString}["AATATAGTCCGGAAGATTT"]
TCACCACAGCGAACGACGC	SubString{ASCIIString}["CACCACAGCGAACGACGCG"]
ACATGTTACCAGATCCGAG	SubString{ASCIIString}["CATGTTACCAGATCCGAGG"]
CCAACTAGTTCTGACCTAA	SubString{ASCIIString}["CAACTAGTTCTGACCTAAT"]
GTAACCGCTTGCGACAAGG	SubString{ASCIIString}["TAACCGCTTGCGACAAGGT"]
GGGTTGCGTTCGACAGTTA	SubString{ASCIIString}["GGTTGCGTTCGACAGTTAG"]
CCGTGGGCAACTTGTTATA	SubString{ASCIIString}["CGTGGGCAACTTGTTATAG"]
CAAGTGTAAGGGTGTGGAG	SubString{ASCIIString}["AAGTGTAAGGGTGTGGAGC"]
ATGGGGACATATCTAACCG	SubString{ASCIIString}["TGGGGACATATCTAACCGC"]
AATCGTGCAACCAAGTGTA	SubString{ASCIIString}["ATCGTGCAACCAAGTGTAA"]
CCAGAACGGCCCCTAGACT	SubString{ASCIIString}["CAGAACGGCCCCTAGACTC"]
AATCGCCAAATCACCAACA	SubString{ASCIIString}["ATCGCCAAATCACCAACAG"]
TTGGGGCTCAGGCGTGATC	SubString{ASCIIString}["TGGGGCTCAGGCGTGATCT"]
AGAGGCTTATTTTGGGCCA	SubString{ASCIIString}["GAGGCTTATTTTGGGCCAG"]
GGCTTATCAACGCCCATTT	SubString{ASCIIString}["GCTTATCAACGCCCATTTT"]
ATTCTTAGATAATCGCGCG	SubString{ASCIIString}["TTCTTAGATAATCGCGCGC"]
AGGGGGTATGTGGAACTTA	SubString{ASCIIString}["GGGGGTATGTGGAACTTAT"]
ACTGTGTACCCTGCGCGGT	SubString{ASCIIString}["CTGTGTACCCTGCGCGGTC"]
TCATAGAGGCTTATTTTGG	SubString{ASCIIString}["CATAGAGGCTTATTTTGGG"]
TAGTCTAAGCGCTACCGTC	SubString{ASCIIString}["AGTCTAAGCGCTACCGTCG"]
TCGGTTGAAGACATTTTCC	SubString{ASCIIString}["CGGTTGAAGACATTTTCCC"]
CTCCTGCCTTCATCTTTAA	SubString{ASCIIString}["TCCTGCCTTCATCTTTAAA"]
CGGTATTCCGGCATTCGCC	SubString{ASCIIString}["GGTATTCCGGCATTCGCCA"]
CTTGTCCATCTAAATCGTG	SubString{ASCIIString}["TTGTCCATCTAAATCGTGC"]
TTCATGACCTGGGTTGCGT	SubString{ASCIIString}["TCATGACCTGGGTTGCGTT"]
TGGCTGAATGTTCCTACTC	SubString{ASCIIString}["GGCTGAATGTTCCTACTCG"]
CACTAGTCCGGACCCTGCA	SubString{ASCIIString}["ACTAGTCCGGACCCTGCAA"]
TCCCTTTATATGAGCACGG	SubString{ASCIIString}["CCCTTTATATGAGCACGGA"]
CGGAGTTCTAAGCGACTTA	SubString{ASCIIString}["GGAGTTCTAAGCGACTTAT"]
CGGGAGGTGCTGGCTAGCG	SubString{ASCIIString}["GGGAGGTGCTGGCTAGCGT"]
ACATGGTCATTTAGACAGA	SubString{ASCIIString}["CATGGTCATTTAGACAGAT"]
ATGGCTGAATGTTCCTACT	SubString{ASCIIString}["TGGCTGAATGTTCCTACTC"]
TTTGGGCCAGAACGGCCCC	SubString{ASCIIString}["TTGGGCCAGAACGGCCCCT"]
GGCGGAGTTCTAAGCGACT	SubString{ASCIIString}["GCGGAGTTCTAAGCGACTT"]
CAAAATCTCGCCCTCTCTG	SubString{ASCIIString}["AAAATCTCGCCCTCTCTGG"]
CCGGTAAACTCCAAACCTG	SubString{ASCIIString}["CGGTAAACTCCAAACCTGA"]
CGACAGTTAGCAACAAAAA	SubString{ASCIIString}["GACAGTTAGCAACAAAAAG"]
TAGGAGTGTCCACCTATGA	SubString{ASCIIString}["AGGAGTGTCCACCTATGAC"]
TGCAGTGCGTAGGGGGTAT	SubString{ASCIIString}["GCAGTGCGTAGGGGGTATG"]
ACCAGGGCCTGTTCGCAGC	SubString{ASCIIString}["CCAGGGCCTGTTCGCAGCC"]
AGTTTGCATTCCACAGATG	SubString{ASCIIString}["GTTTGCATTCCACAGATGG"]
AGTGGAGTACAAAAATGTT	SubString{ASCIIString}["GTGGAGTACAAAAATGTTG"]
CTGGGAAGTCGTGCACAGT	SubString{ASCIIString}["TGGGAAGTCGTGCACAGTA"]
AGCTGACAGGGGCAGTCAT	SubString{ASCIIString}["GCTGACAGGGGCAGTCATA"]
GTTGGACCCTATCCGTGGG	SubString{ASCIIString}["TTGGACCCTATCCGTGGGC"]
GCATGGGGACATATCTAAC	SubString{ASCIIString}["CATGGGGACATATCTAACC"]
GGTTGCAAAATCTCGCCCT	SubString{ASCIIString}["GTTGCAAAATCTCGCCCTC"]
GCATTCCACAGATGGCTGA	SubString{ASCIIString}["CATTCCACAGATGGCTGAA"]
ACAGTAGTCCTCCATAATC	SubString{ASCIIString}["CAGTAGTCCTCCATAATCG"]
TTAGGAGTGTCCACCTATG	SubString{ASCIIString}["TAGGAGTGTCCACCTATGA"]
AGTCAGTGGAGTACAAAAA	SubString{ASCIIString}["GTCAGTGGAGTACAAAAAT"]
TTGTCATGGGTTCATGACC	SubString{ASCIIString}["TGTCATGGGTTCATGACCA"]
TATCATAGAGGCTTATTTT	SubString{ASCIIString}["ATCATAGAGGCTTATTTTG"]
CGAATTGAGGCCGAACCCA	SubString{ASCIIString}["GAATTGAGGCCGAACCCAC"]
CTATGACCTTCCAGACAGA	SubString{ASCIIString}["TATGACCTTCCAGACAGAC"]
AGGTAATCGCCCGAGTGTC	SubString{ASCIIString}["GGTAATCGCCCGAGTGTCT"]
TGGCGAACCTAGGCACCCA	SubString{ASCIIString}["GGCGAACCTAGGCACCCAC"]
GTTAGCAACAAAAAGAAGA	SubString{ASCIIString}["TTAGCAACAAAAAGAAGAG"]
TTTCAATTGATCCTCTTTT	SubString{ASCIIString}["TTCAATTGATCCTCTTTTA"]
TCAGCAATAGTCTAAGCGC	SubString{ASCIIString}["CAGCAATAGTCTAAGCGCT"]
GTTCATGGTACCTTAGTCC	SubString{ASCIIString}["TTCATGGTACCTTAGTCCG"]
CAAGTTTGCATTCCACAGA	SubString{ASCIIString}["AAGTTTGCATTCCACAGAT"]
AAGCCATGTAGGAGGAGAA	SubString{ASCIIString}["AGCCATGTAGGAGGAGAAG"]
GGGACTCATTCAATTCTTA	SubString{ASCIIString}["GGACTCATTCAATTCTTAG"]
CCCTCTCTGGTTCCGTAGC	SubString{ASCIIString}["CCTCTCTGGTTCCGTAGCC"]
CTAAATCGTGCAACCAAGT	SubString{ASCIIString}["TAAATCGTGCAACCAAGTG"]
ATGCAAGTAATAAGGTCCC	SubString{ASCIIString}["TGCAAGTAATAAGGTCCCC"]
ATGACCAGGGCCTGTTCGC	SubString{ASCIIString}["TGACCAGGGCCTGTTCGCA"]
TTCGCAGCTGGAAGTTTCA	SubString{ASCIIString}["TCGCAGCTGGAAGTTTCAC"]
TCCAAACCTGAATCGGGAG	SubString{ASCIIString}["CCAAACCTGAATCGGGAGG"]
TCCATCTAAATCGTGCAAC	SubString{ASCIIString}["CCATCTAAATCGTGCAACC"]
ATGGGGCCTTATGAGTGTA	SubString{ASCIIString}["TGGGGCCTTATGAGTGTAT"]
AATGGATGTCCGAAAATCG	SubString{ASCIIString}["ATGGATGTCCGAAAATCGC"]
GAACCTAGGCACCCACGGC	SubString{ASCIIString}["AACCTAGGCACCCACGGCA"]
CTGAATGTTCCTACTCGCC	SubString{ASCIIString}["TGAATGTTCCTACTCGCCC"]
CAGGCGTGATCTGATGGGT	SubString{ASCIIString}["AGGCGTGATCTGATGGGTT"]
GGCATGTAGGAGGAGAAGT	SubString{ASCIIString}["GCATGTAGGAGGAGAAGTA","GCATGTAGGAGGAGAAGTA"]
CGCCAAATACGATTATCAC	SubString{ASCIIString}["GCCAAATACGATTATCACA"]
AATGCAGCACCAGCCAGTT	SubString{ASCIIString}["ATGCAGCACCAGCCAGTTC"]
AGCGCGTGGGAGATGCCGC	SubString{ASCIIString}["GCGCGTGGGAGATGCCGCC"]
TGTTGCTGCGGGTCGAGTC	SubString{ASCIIString}["GTTGCTGCGGGTCGAGTCG"]
GCATGTAGGAGGAGAAGTA	SubString{ASCIIString}["CATGTAGGAGGAGAAGTAA","CATGTAGGAGGAGAAGTAA"]
GTCTTTCCGGAAGGCAGTT	SubString{ASCIIString}["TCTTTCCGGAAGGCAGTTC"]
TCCGGACCCTGCAACCCCG	SubString{ASCIIString}["CCGGACCCTGCAACCCCGG"]
GACGCTTGAAAAGATGCAG	SubString{ASCIIString}["ACGCTTGAAAAGATGCAGT"]
GCCTTATGAGTGTATGCTG	SubString{ASCIIString}["CCTTATGAGTGTATGCTGC"]
TGTTCGCAGCCCTACCCGG	SubString{ASCIIString}["GTTCGCAGCCCTACCCGGT"]
TAAACTCCAAACCTGAATC	SubString{ASCIIString}["AAACTCCAAACCTGAATCG"]
CTTGTCATGGGTTCATGAC	SubString{ASCIIString}["TTGTCATGGGTTCATGACC"]
TATTCTCGTCGTGAGGCTA	SubString{ASCIIString}["ATTCTCGTCGTGAGGCTAG"]
CCGTGTTGCTGCGGGTCGA	SubString{ASCIIString}["CGTGTTGCTGCGGGTCGAG"]
GCAAAATCTCGCCCTCTCT	SubString{ASCIIString}["CAAAATCTCGCCCTCTCTG"]
CTAATAGCTGACAGGGGCA	SubString{ASCIIString}["TAATAGCTGACAGGGGCAG"]
GTGCACAGTAGTCCTCCAT	SubString{ASCIIString}["TGCACAGTAGTCCTCCATA"]
TGGATGTCCGAAAATCGCC	SubString{ASCIIString}["GGATGTCCGAAAATCGCCA"]
ATGTCAAGCACCCATCTAG	SubString{ASCIIString}["TGTCAAGCACCCATCTAGC"]
CAAAAAGCCATGTAGGAGG	SubString{ASCIIString}["AAAAAGCCATGTAGGAGGA"]
CCGCCAGTTAGTTTCGCGC	SubString{ASCIIString}["CGCCAGTTAGTTTCGCGCT"]
AAGTCTACGTTAGGAGTGT	SubString{ASCIIString}["AGTCTACGTTAGGAGTGTC"]
TGCACTGTGGTTGCAAAAT	SubString{ASCIIString}["GCACTGTGGTTGCAAAATC"]
CGCCCCTGGCGAACCTAGG	SubString{ASCIIString}["GCCCCTGGCGAACCTAGGC"]
ACAATGATTCGGGCGACAC	SubString{ASCIIString}["CAATGATTCGGGCGACACC"]
TAGCCATGAGAGCTGACAG	SubString{ASCIIString}["AGCCATGAGAGCTGACAGC"]
AATCGCCAAATTGTTCGCG	SubString{ASCIIString}["ATCGCCAAATTGTTCGCGG"]
AGCGCTACCGTCGTCCTTG	SubString{ASCIIString}["GCGCTACCGTCGTCCTTGT"]
AGATGCAGTAGGCGGAGTT	SubString{ASCIIString}["GATGCAGTAGGCGGAGTTC"]
TCGGGAGGTGCTGGCTAGC	SubString{ASCIIString}["CGGGAGGTGCTGGCTAGCG"]
TTGCCGCATGGGGACATAT	SubString{ASCIIString}["TGCCGCATGGGGACATATC"]
AATAATACAGATTCGTAGA	SubString{ASCIIString}["ATAATACAGATTCGTAGAC"]
CAGCCACAGACACCAACCT	SubString{ASCIIString}["AGCCACAGACACCAACCTC"]
GGGCCTGTTCGCAGCCCTA	SubString{ASCIIString}["GGCCTGTTCGCAGCCCTAC"]
ATAATCGCGCGCAAGTTTG	SubString{ASCIIString}["TAATCGCGCGCAAGTTTGC"]
GATGGGTTTGACACGAGAT	SubString{ASCIIString}["ATGGGTTTGACACGAGATA"]
CTTAGTCCGAAAATCGCCA	SubString{ASCIIString}["TTAGTCCGAAAATCGCCAA"]
CAAAAATGTTGGACCCTAT	SubString{ASCIIString}["AAAAATGTTGGACCCTATC"]
AGCTAGCCATGAGAGCTGA	SubString{ASCIIString}["GCTAGCCATGAGAGCTGAC"]
TCTGCACTGTGGTTGCAAA	SubString{ASCIIString}["CTGCACTGTGGTTGCAAAA"]
CCCCGGTTCGCTTGTGCGT	SubString{ASCIIString}["CCCGGTTCGCTTGTGCGTT"]
GACCAGGGCCTGTTCGCAG	SubString{ASCIIString}["ACCAGGGCCTGTTCGCAGC"]
ATGGCAAAAAGCCATGTAG	SubString{ASCIIString}["TGGCAAAAAGCCATGTAGG"]
GTTTGACACGAGATACATT	SubString{ASCIIString}["TTTGACACGAGATACATTC"]
CTTAACAAGAAATGATCAC	SubString{ASCIIString}["TTAACAAGAAATGATCACC"]
TGCGCGGTCAACTGGGAAG	SubString{ASCIIString}["GCGCGGTCAACTGGGAAGT"]
ACCTGGGTTGCGTTCGACA	SubString{ASCIIString}["CCTGGGTTGCGTTCGACAG"]
AACAGTGTGCATACAGCCC	SubString{ASCIIString}["ACAGTGTGCATACAGCCCT"]
ATGCTGCCACACAGCCACA	SubString{ASCIIString}["TGCTGCCACACAGCCACAG"]
ACGACGCGGGCTTGCGCAT	SubString{ASCIIString}["CGACGCGGGCTTGCGCATC"]
CAACAAAAAGAAGAGAATA	SubString{ASCIIString}["AACAAAAAGAAGAGAATAC"]
TAATCGCGCGCAAGTTTGC	SubString{ASCIIString}["AATCGCGCGCAAGTTTGCA"]
AAAAAGCCATGTAGGAGGA	SubString{ASCIIString}["AAAAGCCATGTAGGAGGAG"]
ATATCTAACCGCCCCTGGC	SubString{ASCIIString}["TATCTAACCGCCCCTGGCG"]
ACAGGTTAATGTGCGTACT	SubString{ASCIIString}["CAGGTTAATGTGCGTACTG"]
ACAGCCCTAATAGCTGACA	SubString{ASCIIString}["CAGCCCTAATAGCTGACAG"]
CGTGATCTGATGGGTTTGA	SubString{ASCIIString}["GTGATCTGATGGGTTTGAC"]
CGTGCAACCAAGTGTAAGG	SubString{ASCIIString}["GTGCAACCAAGTGTAAGGG"]
TCTTTTAATAATACAGATT	SubString{ASCIIString}["CTTTTAATAATACAGATTC"]
CAAGAGAAACACGCTGAGC	SubString{ASCIIString}["AAGAGAAACACGCTGAGCA"]
GTGTGCATACAGCCCTAAT	SubString{ASCIIString}["TGTGCATACAGCCCTAATA"]
TCACACCGTGTTTTGATTA	SubString{ASCIIString}["CACACCGTGTTTTGATTAT"]
CAGCTCGCGCCCACATCTA	SubString{ASCIIString}["AGCTCGCGCCCACATCTAG"]
GAAAAATTCACGGTAGCGC	SubString{ASCIIString}["AAAAATTCACGGTAGCGCG"]
GACAGATGTCAAGCACCCA	SubString{ASCIIString}["ACAGATGTCAAGCACCCAT"]
GTCTACGTTAGGAGTGTCC	SubString{ASCIIString}["TCTACGTTAGGAGTGTCCA"]
CGAAAATCGCCAAATTGTT	SubString{ASCIIString}["GAAAATCGCCAAATTGTTC"]
ACCTCGCGCGGTTCTACGT	SubString{ASCIIString}["CCTCGCGCGGTTCTACGTG"]
CCTGGCCCACCTGTTTGAA	SubString{ASCIIString}["CTGGCCCACCTGTTTGAAA"]
AACAGGCATGTAGGAGGAG	SubString{ASCIIString}["ACAGGCATGTAGGAGGAGA"]
CGCGTGGGAGATGCCGCCA	SubString{ASCIIString}["GCGTGGGAGATGCCGCCAT"]
GAAAGTCAGTGGAGTACAA	SubString{ASCIIString}["AAAGTCAGTGGAGTACAAA"]
AGGCTAGATTTACTAAAGC	SubString{ASCIIString}["GGCTAGATTTACTAAAGCT"]
CTACGTTTGCCGCATGGGG	SubString{ASCIIString}["TACGTTTGCCGCATGGGGA"]
GACATTTTCCCCTACGTTT	SubString{ASCIIString}["ACATTTTCCCCTACGTTTG"]
AGGCACCCACGGCATGCCC	SubString{ASCIIString}["GGCACCCACGGCATGCCCT"]
TGCCACACAGCCACAGACA	SubString{ASCIIString}["GCCACACAGCCACAGACAC"]
CGGGCATGTAGGAGGAGAA	SubString{ASCIIString}["GGGCATGTAGGAGGAGAAG"]
GGCATTCGCCACCCACAAT	SubString{ASCIIString}["GCATTCGCCACCCACAATG"]
ATTACAGCCGATATACGGG	SubString{ASCIIString}["TTACAGCCGATATACGGGT"]
TAGAGGCTTATTTTGGGCC	SubString{ASCIIString}["AGAGGCTTATTTTGGGCCA"]
CGAGTCGCCGGTAAACTCC	SubString{ASCIIString}["GAGTCGCCGGTAAACTCCA"]
GATCTGATGGGTTTGACAC	SubString{ASCIIString}["ATCTGATGGGTTTGACACG"]
CATTCAGTGTGAGGCTTAT	SubString{ASCIIString}["ATTCAGTGTGAGGCTTATC"]
GTCCTAGGACCGTCTCAGG	SubString{ASCIIString}["TCCTAGGACCGTCTCAGGA"]
CATCTTTAAACAGTGTGCA	SubString{ASCIIString}["ATCTTTAAACAGTGTGCAT"]
CACATCTAGGGACTCATTC	SubString{ASCIIString}["ACATCTAGGGACTCATTCA"]
GGTTAATGTGCGTACTGCG	SubString{ASCIIString}["GTTAATGTGCGTACTGCGA"]
CGCCAAATGGCAAAAAGCC	SubString{ASCIIString}["GCCAAATGGCAAAAAGCCA"]
GCCCGAGTGTCTATACTTA	SubString{ASCIIString}["CCCGAGTGTCTATACTTAT"]
TAAGCGACTTATCATAGAG	SubString{ASCIIString}["AAGCGACTTATCATAGAGG"]
GCTTGCGACAAGGTCCTAG	SubString{ASCIIString}["CTTGCGACAAGGTCCTAGG"]
GCGGGCATGTAGGAGGAGA	SubString{ASCIIString}["CGGGCATGTAGGAGGAGAA"]
TCATCTCCCTGGCCCACCT	SubString{ASCIIString}["CATCTCCCTGGCCCACCTG"]
GAGATACATTCAGTGTGAG	SubString{ASCIIString}["AGATACATTCAGTGTGAGG"]
CATGTTACCAGATCCGAGG	SubString{ASCIIString}["ATGTTACCAGATCCGAGGA"]
TTTAGGCCTCGAAAAACCA	SubString{ASCIIString}["TTAGGCCTCGAAAAACCAA"]
AACGGCCCCTAGACTCCGA	SubString{ASCIIString}["ACGGCCCCTAGACTCCGAG"]
TCTTTAAACAGTGTGCATA	SubString{ASCIIString}["CTTTAAACAGTGTGCATAC"]
ACACCACAACAAGAGAAAC	SubString{ASCIIString}["CACCACAACAAGAGAAACA"]
ACGCGGGCTTGCGCATCAT	SubString{ASCIIString}["CGCGGGCTTGCGCATCATT"]
ATGAGCACGGAAAGTCAGT	SubString{ASCIIString}["TGAGCACGGAAAGTCAGTG"]
GGCTAGCGTGAAAAATTCA	SubString{ASCIIString}["GCTAGCGTGAAAAATTCAC"]
CGTTAGGAGTGTCCACCTA	SubString{ASCIIString}["GTTAGGAGTGTCCACCTAT"]
TGGCCAATGCAAGTAATAA	SubString{ASCIIString}["GGCCAATGCAAGTAATAAG"]
AAGTTTCACTAATTTGTCT	SubString{ASCIIString}["AGTTTCACTAATTTGTCTT"]
GATTATCACATGTAGGAGG	SubString{ASCIIString}["ATTATCACATGTAGGAGGA"]
TCGCGCTTACCTGAATGGA	SubString{ASCIIString}["CGCGCTTACCTGAATGGAT"]
AGTCCGGAAGATTTTCCCT	SubString{ASCIIString}["GTCCGGAAGATTTTCCCTG"]
AATGTTCCTACTCGCCCTA	SubString{ASCIIString}["ATGTTCCTACTCGCCCTAT"]
CGCGCGCAAGTTTGCATTC	SubString{ASCIIString}["GCGCGCAAGTTTGCATTCC"]
TTATTTTGGCCAATGCAAG	SubString{ASCIIString}["TATTTTGGCCAATGCAAGT"]
CCACCTGTTTGAAAAGTTC	SubString{ASCIIString}["CACCTGTTTGAAAAGTTCA"]
ATCAAATCCGGGCAGCCAA	SubString{ASCIIString}["TCAAATCCGGGCAGCCAAC"]
GCGCGGTTCTACGTGTCAG	SubString{ASCIIString}["CGCGGTTCTACGTGTCAGC"]
CTGGTTCCGTAGCCGCTCT	SubString{ASCIIString}["TGGTTCCGTAGCCGCTCTA"]
ATAGAGGCTTATTTTGGGC	SubString{ASCIIString}["TAGAGGCTTATTTTGGGCC"]
TTTCTGGCGCGCGGTTGGG	SubString{ASCIIString}["TTCTGGCGCGCGGTTGGGG"]
TGAAAAGTTCATGGTACCT	SubString{ASCIIString}["GAAAAGTTCATGGTACCTT"]
ACCGTGTTTTGATTATATC	SubString{ASCIIString}["CCGTGTTTTGATTATATCG"]
GTTCAACTTTTGGTGACTT	SubString{ASCIIString}["TTCAACTTTTGGTGACTTA"]
ATCGCCAAATGGCAAAAAG	SubString{ASCIIString}["TCGCCAAATGGCAAAAAGC"]
GAAGTAACCACTGTGTACC	SubString{ASCIIString}["AAGTAACCACTGTGTACCC"]
TTATATCGGTTGAAGACAT	SubString{ASCIIString}["TATATCGGTTGAAGACATT"]
TTCTGGCGCGCGGTTGGGG	SubString{ASCIIString}["TCTGGCGCGCGGTTGGGGG"]
AGATGCCGCCATCTACGGC	SubString{ASCIIString}["GATGCCGCCATCTACGGCA"]
CATGGGGACATATCTAACC	SubString{ASCIIString}["ATGGGGACATATCTAACCG"]
GGCCTCGAAAAACCAATCT	SubString{ASCIIString}["GCCTCGAAAAACCAATCTA"]
AGGAGAAGTAACCACTGTG	SubString{ASCIIString}["GGAGAAGTAACCACTGTGT"]
AGTAAGTTTAAGGTAATCG	SubString{ASCIIString}["GTAAGTTTAAGGTAATCGC"]
TCAACTGGGAAGTCGTGCA	SubString{ASCIIString}["CAACTGGGAAGTCGTGCAC"]
GCGCGGTTGGGGGCGCTTT	SubString{ASCIIString}["CGCGGTTGGGGGCGCTTTC"]
TCCACCTATGACCTTCCAG	SubString{ASCIIString}["CCACCTATGACCTTCCAGA"]
TGACCTTCCAGACAGACGC	SubString{ASCIIString}["GACCTTCCAGACAGACGCT"]
GGTCCGAAAATCGCCAAAT	SubString{ASCIIString}["GTCCGAAAATCGCCAAATG"]
CACATGTAGGAGGAGAAGT	SubString{ASCIIString}["ACATGTAGGAGGAGAAGTA"]
CGTTCAACTTTTGGTGACT	SubString{ASCIIString}["GTTCAACTTTTGGTGACTT"]
CATGGCACCTTTATTATCG	SubString{ASCIIString}["ATGGCACCTTTATTATCGG"]
CACGAGATACATTCAGTGT	SubString{ASCIIString}["ACGAGATACATTCAGTGTG"]
AGCCGATATACGGGTCTGC	SubString{ASCIIString}["GCCGATATACGGGTCTGCA"]
GGTCATTTAGACAGATGTC	SubString{ASCIIString}["GTCATTTAGACAGATGTCA"]
GAGACATGTTACCAGATCC	SubString{ASCIIString}["AGACATGTTACCAGATCCG"]
ACCGCCAGTTAGTTTCGCG	SubString{ASCIIString}["CCGCCAGTTAGTTTCGCGC"]
GAGAAACACGCTGAGCAAA	SubString{ASCIIString}["AGAAACACGCTGAGCAAAA"]
CATTACAGCCGATATACGG	SubString{ASCIIString}["ATTACAGCCGATATACGGG"]
GGGCGACACCACAACAAGA	SubString{ASCIIString}["GGCGACACCACAACAAGAG"]
ATTCCCTTTATATGAGCAC	SubString{ASCIIString}["TTCCCTTTATATGAGCACG"]
TCTACGTGTCAGCAATAGT	SubString{ASCIIString}["CTACGTGTCAGCAATAGTC"]
CCCCTGGCGAACCTAGGCA	SubString{ASCIIString}["CCCTGGCGAACCTAGGCAC"]
CAGCGATACTTTCACACCG	SubString{ASCIIString}["AGCGATACTTTCACACCGT"]
CATTCCCTTTATATGAGCA	SubString{ASCIIString}["ATTCCCTTTATATGAGCAC"]
GTAGCGCGAATTGAGGCCG	SubString{ASCIIString}["TAGCGCGAATTGAGGCCGA"]
AAATGATCACCCCGTGTTG	SubString{ASCIIString}["AATGATCACCCCGTGTTGC"]
CCTAATATAGTCCGGAAGA	SubString{ASCIIString}["CTAATATAGTCCGGAAGAT"]
GGCCTGTTCGCAGCCCTAC	SubString{ASCIIString}["GCCTGTTCGCAGCCCTACC"]
ATGGGTTTGACACGAGATA	SubString{ASCIIString}["TGGGTTTGACACGAGATAC"]
CTCGCGCCCACATCTAGGG	SubString{ASCIIString}["TCGCGCCCACATCTAGGGA"]
TGTCCGAAAATCGCCAAAT	SubString{ASCIIString}["GTCCGAAAATCGCCAAATT"]
ATAATCGGAGACATGTTAC	SubString{ASCIIString}["TAATCGGAGACATGTTACC"]
AAGACATTTTCCCCTACGT	SubString{ASCIIString}["AGACATTTTCCCCTACGTT"]
GAAAATCGCCAAATGGCAA	SubString{ASCIIString}["AAAATCGCCAAATGGCAAA"]
GTTCACATGGTCATTTAGA	SubString{ASCIIString}["TTCACATGGTCATTTAGAC"]
GTTTGAAAAGTTCATGGTA	SubString{ASCIIString}["TTTGAAAAGTTCATGGTAC"]
AGTGTCCACCTATGACCTT	SubString{ASCIIString}["GTGTCCACCTATGACCTTC"]
TGCAGCACCAGCCAGTTCT	SubString{ASCIIString}["GCAGCACCAGCCAGTTCTC"]
GCCAAATTGTTCGCGGGCA	SubString{ASCIIString}["CCAAATTGTTCGCGGGCAT"]
ACGGAAAGTCAGTGGAGTA	SubString{ASCIIString}["CGGAAAGTCAGTGGAGTAC"]
GACATGGCACCTTTATTAT	SubString{ASCIIString}["ACATGGCACCTTTATTATC"]
TTAAACAGTGTGCATACAG	SubString{ASCIIString}["TAAACAGTGTGCATACAGC"]
GGTGGCTAGTAAAGCGGTT	SubString{ASCIIString}["GTGGCTAGTAAAGCGGTTT"]
AGATGGCTGAATGTTCCTA	SubString{ASCIIString}["GATGGCTGAATGTTCCTAC"]
TAGACTCCGAGCAGCGATA	SubString{ASCIIString}["AGACTCCGAGCAGCGATAC"]
AAATCGCCAAATCACCAAC	SubString{ASCIIString}["AATCGCCAAATCACCAACA"]
GTGGGAGATGCCGCCATCT	SubString{ASCIIString}["TGGGAGATGCCGCCATCTA"]
ACCACAGCGAACGACGCGG	SubString{ASCIIString}["CCACAGCGAACGACGCGGG"]
ACCCACTAGTCCGGACCCT	SubString{ASCIIString}["CCCACTAGTCCGGACCCTG"]
GGGAGATGCCGCCATCTAC	SubString{ASCIIString}["GGAGATGCCGCCATCTACG"]
AGTTAGTTTCGCGCTTACC	SubString{ASCIIString}["GTTAGTTTCGCGCTTACCT"]
TCGCCACCCACAATGATTC	SubString{ASCIIString}["CGCCACCCACAATGATTCG"]
GTTTTCAATTGATCCTCTT	SubString{ASCIIString}["TTTTCAATTGATCCTCTTT"]
CCTGTTCGCAGCCCTACCC	SubString{ASCIIString}["CTGTTCGCAGCCCTACCCG"]
AACAAAAAGAAGAGAATAC	SubString{ASCIIString}["ACAAAAAGAAGAGAATACT"]
AGATGTCAAGCACCCATCT	SubString{ASCIIString}["GATGTCAAGCACCCATCTA"]
AGTCATACTGGACATGGCA	SubString{ASCIIString}["GTCATACTGGACATGGCAC"]
GGTTTGACACGAGATACAT	SubString{ASCIIString}["GTTTGACACGAGATACATT"]
ACGTTCAACTTTTGGTGAC	SubString{ASCIIString}["CGTTCAACTTTTGGTGACT"]
GTCCCCGTTGTTGTGGTCG	SubString{ASCIIString}["TCCCCGTTGTTGTGGTCGT"]
CGTGTTTTGATTATATCGG	SubString{ASCIIString}["GTGTTTTGATTATATCGGT"]
TTAGATAATCGCGCGCAAG	SubString{ASCIIString}["TAGATAATCGCGCGCAAGT"]
GGAACTTATTTTGGCCAAT	SubString{ASCIIString}["GAACTTATTTTGGCCAATG"]
ACATGTAGGAGGAGAAGTA	SubString{ASCIIString}["CATGTAGGAGGAGAAGTAA"]
GTGCGTTCACATGGTCATT	SubString{ASCIIString}["TGCGTTCACATGGTCATTT"]
GAAAATCGCCAAATCACCA	SubString{ASCIIString}["AAAATCGCCAAATCACCAA"]
ACCTCTGCACTGTGGTTGC	SubString{ASCIIString}["CCTCTGCACTGTGGTTGCA"]
GTAGGAGGAGAAGTAACAT	SubString{ASCIIString}["TAGGAGGAGAAGTAACATC"]
CGGAAGGCAGTTCATCTCC	SubString{ASCIIString}["GGAAGGCAGTTCATCTCCC"]
CAATAGTCTAAGCGCTACC	SubString{ASCIIString}["AATAGTCTAAGCGCTACCG"]
CGCTGAGCAAAATATGGGG	SubString{ASCIIString}["GCTGAGCAAAATATGGGGC"]
GGGGCGCTTTCAAAGCCTT	SubString{ASCIIString}["GGGCGCTTTCAAAGCCTTG"]
TTTTGGCCAATGCAAGTAA	SubString{ASCIIString}["TTTGGCCAATGCAAGTAAT"]
CCGAAAATCGCCAAATTGT	SubString{ASCIIString}["CGAAAATCGCCAAATTGTT"]
AGTGTTTAGGCCTCGAAAA	SubString{ASCIIString}["GTGTTTAGGCCTCGAAAAA"]
GAAGATTTTCCCTGTTCGG	SubString{ASCIIString}["AAGATTTTCCCTGTTCGGC"]
TCCGAGGATCTGGTGGCTA	SubString{ASCIIString}["CCGAGGATCTGGTGGCTAG"]
TCGTGAGGCTAGATTTACT	SubString{ASCIIString}["CGTGAGGCTAGATTTACTA"]
GTTCGGCCGATTAAGTAAG	SubString{ASCIIString}["TTCGGCCGATTAAGTAAGT"]
GGTCCCCGTTGTTGTGGTC	SubString{ASCIIString}["GTCCCCGTTGTTGTGGTCG"]
CACCAACCTCTGCACTGTG	SubString{ASCIIString}["ACCAACCTCTGCACTGTGG"]
AAGTAACCGCTTGCGACAA	SubString{ASCIIString}["AGTAACCGCTTGCGACAAG"]
GTTGCGTTCGACAGTTAGC	SubString{ASCIIString}["TTGCGTTCGACAGTTAGCA"]
CCTCGCGCGGTTCTACGTG	SubString{ASCIIString}["CTCGCGCGGTTCTACGTGT"]
TGGACATGGCACCTTTATT	SubString{ASCIIString}["GGACATGGCACCTTTATTA"]
TGTAGGAGGAGAAGTAACC	SubString{ASCIIString}["GTAGGAGGAGAAGTAACCA","GTAGGAGGAGAAGTAACCG","GTAGGAGGAGAAGTAACCA"]
GAGAAGTAACCATGCCGAC	SubString{ASCIIString}["AGAAGTAACCATGCCGACC"]
GGAGAAGTAACCGCTTGCG	SubString{ASCIIString}["GAGAAGTAACCGCTTGCGA"]
CCGGAAGGCAGTTCATCTC	SubString{ASCIIString}["CGGAAGGCAGTTCATCTCC"]
AGCCGCTCTATCGGCTCTT	SubString{ASCIIString}["GCCGCTCTATCGGCTCTTC"]
AGAAGTAACCATGCCGACC	SubString{ASCIIString}["GAAGTAACCATGCCGACCC"]
CATATCTAACCGCCCCTGG	SubString{ASCIIString}["ATATCTAACCGCCCCTGGC"]
CTGGGTTGCGTTCGACAGT	SubString{ASCIIString}["TGGGTTGCGTTCGACAGTT"]
AATGATTCGGGCGACACCA	SubString{ASCIIString}["ATGATTCGGGCGACACCAC"]
ACCTTAGTCCGAAAATCGC	SubString{ASCIIString}["CCTTAGTCCGAAAATCGCC"]
TGGGGGCGCTTTCAAAGCC	SubString{ASCIIString}["GGGGGCGCTTTCAAAGCCT"]
TGGCCCACCTGTTTGAAAA	SubString{ASCIIString}["GGCCCACCTGTTTGAAAAG"]
GAGGATCTGGTGGCTAGTA	SubString{ASCIIString}["AGGATCTGGTGGCTAGTAA"]
CTTATCAACGCCCATTTTC	SubString{ASCIIString}["TTATCAACGCCCATTTTCT"]
GGAAGTTTCACTAATTTGT	SubString{ASCIIString}["GAAGTTTCACTAATTTGTC"]
CAAATCCGGGCAGCCAACT	SubString{ASCIIString}["AAATCCGGGCAGCCAACTA"]
GGTACAGGTTAATGTGCGT	SubString{ASCIIString}["GTACAGGTTAATGTGCGTA"]
TGTGGTCGTGTTTTGGGGC	SubString{ASCIIString}["GTGGTCGTGTTTTGGGGCT"]
GACATGTTACCAGATCCGA	SubString{ASCIIString}["ACATGTTACCAGATCCGAG"]
AGCGACTTATCATAGAGGC	SubString{ASCIIString}["GCGACTTATCATAGAGGCT"]
GTTTAGGCCTCGAAAAACC	SubString{ASCIIString}["TTTAGGCCTCGAAAAACCA"]
ATTTTCCCTGTTCGGCCGA	SubString{ASCIIString}["TTTTCCCTGTTCGGCCGAT"]
AAATCGCCAAATTGTTCGC	SubString{ASCIIString}["AATCGCCAAATTGTTCGCG"]
CGAACCTAGGCACCCACGG	SubString{ASCIIString}["GAACCTAGGCACCCACGGC"]
ACAGACACCAACCTCTGCA	SubString{ASCIIString}["CAGACACCAACCTCTGCAC"]
TCGTCGTGAGGCTAGATTT	SubString{ASCIIString}["CGTCGTGAGGCTAGATTTA"]
ACTTAACAAGAAATGATCA	SubString{ASCIIString}["CTTAACAAGAAATGATCAC"]
CATCTAGCAGTGTTTAGGC	SubString{ASCIIString}["ATCTAGCAGTGTTTAGGCC"]
CGATTATCACATGTAGGAG	SubString{ASCIIString}["GATTATCACATGTAGGAGG"]
AGCACGGAAAGTCAGTGGA	SubString{ASCIIString}["GCACGGAAAGTCAGTGGAG"]
GCCCTAATAGCTGACAGGG	SubString{ASCIIString}["CCCTAATAGCTGACAGGGG"]
GTGTTTTGATTATATCGGT	SubString{ASCIIString}["TGTTTTGATTATATCGGTT"]
CAATGCAAGTAATAAGGTC	SubString{ASCIIString}["AATGCAAGTAATAAGGTCC"]
TTCGTAGACGTTCAACTTT	SubString{ASCIIString}["TCGTAGACGTTCAACTTTT"]
ATTATCGGCAATGCAGCAC	SubString{ASCIIString}["TTATCGGCAATGCAGCACC"]
GGTGTGGAGCACCTCGCGC	SubString{ASCIIString}["GTGTGGAGCACCTCGCGCG"]
GCACGGAAAGTCAGTGGAG	SubString{ASCIIString}["CACGGAAAGTCAGTGGAGT"]
TGCCGCATGGGGACATATC	SubString{ASCIIString}["GCCGCATGGGGACATATCT"]
TTAAGGTAATCGCCCGAGT	SubString{ASCIIString}["TAAGGTAATCGCCCGAGTG"]
CAACCAAGTGTAAGGGTGT	SubString{ASCIIString}["AACCAAGTGTAAGGGTGTG"]
CACATGGTCATTTAGACAG	SubString{ASCIIString}["ACATGGTCATTTAGACAGA"]
CTCGCGCGGTTCTACGTGT	SubString{ASCIIString}["TCGCGCGGTTCTACGTGTC"]
GCAGCCCTACCCGGTCCGA	SubString{ASCIIString}["CAGCCCTACCCGGTCCGAA"]
AGGAAGTCTACGTTAGGAG	SubString{ASCIIString}["GGAAGTCTACGTTAGGAGT"]
TGATTCGGGCGACACCACA	SubString{ASCIIString}["GATTCGGGCGACACCACAA"]
CTAGGGACTCATTCAATTC	SubString{ASCIIString}["TAGGGACTCATTCAATTCT"]
AGCCAACTAGTTCTGACCT	SubString{ASCIIString}["GCCAACTAGTTCTGACCTA"]
AGAAGTAACCACTGTGTAC	SubString{ASCIIString}["GAAGTAACCACTGTGTACC"]
GGGCGCTTTCAAAGCCTTG	SubString{ASCIIString}["GGCGCTTTCAAAGCCTTGT"]
GAATGGATGTCCGAAAATC	SubString{ASCIIString}["AATGGATGTCCGAAAATCG"]
TTCCCCTACGTTTGCCGCA	SubString{ASCIIString}["TCCCCTACGTTTGCCGCAT"]
CAGAACGGCCCCTAGACTC	SubString{ASCIIString}["AGAACGGCCCCTAGACTCC"]
ATACGGGTCTGCATAGTTG	SubString{ASCIIString}["TACGGGTCTGCATAGTTGA"]
GCTCTATCGGCTCTTCATG	SubString{ASCIIString}["CTCTATCGGCTCTTCATGA"]
CACAGTAGTCCTCCATAAT	SubString{ASCIIString}["ACAGTAGTCCTCCATAATC"]
CGTTTGCCGCATGGGGACA	SubString{ASCIIString}["GTTTGCCGCATGGGGACAT"]
CCCACAATGATTCGGGCGA	SubString{ASCIIString}["CCACAATGATTCGGGCGAC"]
GGGTATGTGGAACTTATTT	SubString{ASCIIString}["GGTATGTGGAACTTATTTT"]
ACCAGATCCGAGGATCTGG	SubString{ASCIIString}["CCAGATCCGAGGATCTGGT"]
CGGCCGATTAAGTAAGTTT	SubString{ASCIIString}["GGCCGATTAAGTAAGTTTA"]
TGTCATGGGTTCATGACCA	SubString{ASCIIString}["GTCATGGGTTCATGACCAG"]
GCGCGTGGGAGATGCCGCC	SubString{ASCIIString}["CGCGTGGGAGATGCCGCCA"]
TTGAAAAGTTCATGGTACC	SubString{ASCIIString}["TGAAAAGTTCATGGTACCT"]
ACATATCTAACCGCCCCTG	SubString{ASCIIString}["CATATCTAACCGCCCCTGG"]
CCGAAAATCGCCAAATCAC	SubString{ASCIIString}["CGAAAATCGCCAAATCACC"]
GCCCTCTCTGGTTCCGTAG	SubString{ASCIIString}["CCCTCTCTGGTTCCGTAGC"]
TAGTTGAATCCGGTACAGG	SubString{ASCIIString}["AGTTGAATCCGGTACAGGT"]
ATGAGAGCTGACAGCGCGT	SubString{ASCIIString}["TGAGAGCTGACAGCGCGTG"]
CGCCACCCACAATGATTCG	SubString{ASCIIString}["GCCACCCACAATGATTCGG"]
AGGGCCTGTTCGCAGCCCT	SubString{ASCIIString}["GGGCCTGTTCGCAGCCCTA"]
GGCGCGCGGTTGGGGGCGC	SubString{ASCIIString}["GCGCGCGGTTGGGGGCGCT"]
CCACCTATGACCTTCCAGA	SubString{ASCIIString}["CACCTATGACCTTCCAGAC"]
TTTTGGGCCAGAACGGCCC	SubString{ASCIIString}["TTTGGGCCAGAACGGCCCC"]
CTAGCGTGAAAAATTCACG	SubString{ASCIIString}["TAGCGTGAAAAATTCACGG"]
CCTAATAGCTGACAGGGGC	SubString{ASCIIString}["CTAATAGCTGACAGGGGCA"]
CCATCTAGCAGTGTTTAGG	SubString{ASCIIString}["CATCTAGCAGTGTTTAGGC"]
CTGTTTGAAAAGTTCATGG	SubString{ASCIIString}["TGTTTGAAAAGTTCATGGT"]
CTAAGCGCTACCGTCGTCC	SubString{ASCIIString}["TAAGCGCTACCGTCGTCCT"]
CTGACAGCGCGTGGGAGAT	SubString{ASCIIString}["TGACAGCGCGTGGGAGATG"]
GGTGACTTAACAAGAAATG	SubString{ASCIIString}["GTGACTTAACAAGAAATGA"]
CCGGTCCGAAAATCGCCAA	SubString{ASCIIString}["CGGTCCGAAAATCGCCAAA"]
ATCGCCAAATTGTTCGCGG	SubString{ASCIIString}["TCGCCAAATTGTTCGCGGG"]
CTATCCGTGGGCAACTTGT	SubString{ASCIIString}["TATCCGTGGGCAACTTGTT"]
TTCCCTGTTCGGCCGATTA	SubString{ASCIIString}["TCCCTGTTCGGCCGATTAA"]
TGCATTCCACAGATGGCTG	SubString{ASCIIString}["GCATTCCACAGATGGCTGA"]
TAGTCCTTTAGTCTTTCCG	SubString{ASCIIString}["AGTCCTTTAGTCTTTCCGG"]
GGCTAGATTTACTAAAGCT	SubString{ASCIIString}["GCTAGATTTACTAAAGCTA"]
CCTGAATGGATGTCCGAAA	SubString{ASCIIString}["CTGAATGGATGTCCGAAAA"]
CCTTTATTATCGGCAATGC	SubString{ASCIIString}["CTTTATTATCGGCAATGCA"]
CAGTCATACTGGACATGGC	SubString{ASCIIString}["AGTCATACTGGACATGGCA"]
GACAGACGCTTGAAAAGAT	SubString{ASCIIString}["ACAGACGCTTGAAAAGATG"]
CAAAATATGGGGCCTTATG	SubString{ASCIIString}["AAAATATGGGGCCTTATGA"]
CCCTGCAACCCCGGTTCGC	SubString{ASCIIString}["CCTGCAACCCCGGTTCGCT"]
TGTGAGGCTTATCAACGCC	SubString{ASCIIString}["GTGAGGCTTATCAACGCCC"]
TGGTGACTTAACAAGAAAT	SubString{ASCIIString}["GGTGACTTAACAAGAAATG"]
TTCATCTTTAAACAGTGTG	SubString{ASCIIString}["TCATCTTTAAACAGTGTGC"]
GGTCAACTGGGAAGTCGTG	SubString{ASCIIString}["GTCAACTGGGAAGTCGTGC"]
GGCCAATGCAAGTAATAAG	SubString{ASCIIString}["GCCAATGCAAGTAATAAGG"]
CGGCATTCGCCACCCACAA	SubString{ASCIIString}["GGCATTCGCCACCCACAAT"]
CCGGCATTCGCCACCCACA	SubString{ASCIIString}["CGGCATTCGCCACCCACAA"]
TTCTAAGCGACTTATCATA	SubString{ASCIIString}["TCTAAGCGACTTATCATAG"]
CATCTCCCTGGCCCACCTG	SubString{ASCIIString}["ATCTCCCTGGCCCACCTGT"]
GAGCAAAATATGGGGCCTT	SubString{ASCIIString}["AGCAAAATATGGGGCCTTA"]
TGTTTTGGGGCTCAGGCGT	SubString{ASCIIString}["GTTTTGGGGCTCAGGCGTG"]
TATAGTCCTTTAGTCTTTC	SubString{ASCIIString}["ATAGTCCTTTAGTCTTTCC"]
ACACAGCCACAGACACCAA	SubString{ASCIIString}["CACAGCCACAGACACCAAC"]
TAGGGACTCATTCAATTCT	SubString{ASCIIString}["AGGGACTCATTCAATTCTT"]
GTGAGGCTTATCAACGCCC	SubString{ASCIIString}["TGAGGCTTATCAACGCCCA"]
TCCGGCATTCGCCACCCAC	SubString{ASCIIString}["CCGGCATTCGCCACCCACA"]
CGCTCTATCGGCTCTTCAT	SubString{ASCIIString}["GCTCTATCGGCTCTTCATG"]
AAAAACCAATCTATACGTC	SubString{ASCIIString}["AAAACCAATCTATACGTCC"]
CGGGTCGAGTCGCCGGTAA	SubString{ASCIIString}["GGGTCGAGTCGCCGGTAAA"]
CAGACACCAACCTCTGCAC	SubString{ASCIIString}["AGACACCAACCTCTGCACT"]
AAGGTCCCCGTTGTTGTGG	SubString{ASCIIString}["AGGTCCCCGTTGTTGTGGT"]
GGGCCAGAACGGCCCCTAG	SubString{ASCIIString}["GGCCAGAACGGCCCCTAGA"]
CTGGCCCACCTGTTTGAAA	SubString{ASCIIString}["TGGCCCACCTGTTTGAAAA"]
ATCTAAATCGTGCAACCAA	SubString{ASCIIString}["TCTAAATCGTGCAACCAAG"]
GCTTACCTGAATGGATGTC	SubString{ASCIIString}["CTTACCTGAATGGATGTCC"]
CGTCCTTGTCATGGGTTCA	SubString{ASCIIString}["GTCCTTGTCATGGGTTCAT"]
CAGCTGGAAGTTTCACTAA	SubString{ASCIIString}["AGCTGGAAGTTTCACTAAT"]
CACCCATCTAGCAGTGTTT	SubString{ASCIIString}["ACCCATCTAGCAGTGTTTA"]
AACTGGGAAGTCGTGCACA	SubString{ASCIIString}["ACTGGGAAGTCGTGCACAG"]
TTCCTACTCGCCCTATATG	SubString{ASCIIString}["TCCTACTCGCCCTATATGC"]
GAGTTCTAAGCGACTTATC	SubString{ASCIIString}["AGTTCTAAGCGACTTATCA"]
GTTTCGCGCTTACCTGAAT	SubString{ASCIIString}["TTTCGCGCTTACCTGAATG"]
TTCAAAGCCTTGTCCATCT	SubString{ASCIIString}["TCAAAGCCTTGTCCATCTA"]
TCCGTGACTCGTGTCGCTA	SubString{ASCIIString}["CCGTGACTCGTGTCGCTAA"]
CCTTTAGTCTTTCCGGAAG	SubString{ASCIIString}["CTTTAGTCTTTCCGGAAGG"]
GCCGCCATCTACGGCATTG	SubString{ASCIIString}["CCGCCATCTACGGCATTGT"]
TCGCCAAATTGTTCGCGGG	SubString{ASCIIString}["CGCCAAATTGTTCGCGGGC"]
CAATCTATACGTCCGAAAA	SubString{ASCIIString}["AATCTATACGTCCGAAAAT"]
GAATGTTCCTACTCGCCCT	SubString{ASCIIString}["AATGTTCCTACTCGCCCTA"]
GCCCCTAGACTCCGAGCAG	SubString{ASCIIString}["CCCCTAGACTCCGAGCAGC"]
GATTATATCGGTTGAAGAC	SubString{ASCIIString}["ATTATATCGGTTGAAGACA"]
GATTCGTAGACGTTCAACT	SubString{ASCIIString}["ATTCGTAGACGTTCAACTT"]
TCCTTGTCATGGGTTCATG	SubString{ASCIIString}["CCTTGTCATGGGTTCATGA"]
TGTGCGTACTGCGAATGTT	SubString{ASCIIString}["GTGCGTACTGCGAATGTTT"]
CCTACCCGGTCCGAAAATC	SubString{ASCIIString}["CTACCCGGTCCGAAAATCG"]
CGTGGGAGATGCCGCCATC	SubString{ASCIIString}["GTGGGAGATGCCGCCATCT"]
GATCCTCTTTTAATAATAC	SubString{ASCIIString}["ATCCTCTTTTAATAATACA"]
CCATCTACGGCATTGTCTA	SubString{ASCIIString}["CATCTACGGCATTGTCTAG"]
CGCAAGTTTGCATTCCACA	SubString{ASCIIString}["GCAAGTTTGCATTCCACAG"]
AAAGAAGAGAATACTTTGA	SubString{ASCIIString}["AAGAAGAGAATACTTTGAT"]
CAACTGGGAAGTCGTGCAC	SubString{ASCIIString}["AACTGGGAAGTCGTGCACA"]
GAGCTGACAGCGCGTGGGA	SubString{ASCIIString}["AGCTGACAGCGCGTGGGAG"]
TCCGAAAATCGCCAAATGG	SubString{ASCIIString}["CCGAAAATCGCCAAATGGC"]
CAGCGAACGACGCGGGCTT	SubString{ASCIIString}["AGCGAACGACGCGGGCTTG"]
GCCAGAACGGCCCCTAGAC	SubString{ASCIIString}["CCAGAACGGCCCCTAGACT"]
CTAGTTTTCGCAGCTGGAA	SubString{ASCIIString}["TAGTTTTCGCAGCTGGAAG"]
TCCGAAAATCGCCAAATTG	SubString{ASCIIString}["CCGAAAATCGCCAAATTGT"]
CCGAAAATCGCCAAATGGC	SubString{ASCIIString}["CGAAAATCGCCAAATGGCA"]
ACTGCGAATGTTTTCAATT	SubString{ASCIIString}["CTGCGAATGTTTTCAATTG"]
AAAATGTTGGACCCTATCC	SubString{ASCIIString}["AAATGTTGGACCCTATCCG"]
TAGACGTTCAACTTTTGGT	SubString{ASCIIString}["AGACGTTCAACTTTTGGTG"]
CAACCTCTGCACTGTGGTT	SubString{ASCIIString}["AACCTCTGCACTGTGGTTG"]
AGTTAGCAACAAAAAGAAG	SubString{ASCIIString}["GTTAGCAACAAAAAGAAGA"]
CAAATGGCAAAAAGCCATG	SubString{ASCIIString}["AAATGGCAAAAAGCCATGT"]
ACCAAGTGTAAGGGTGTGG	SubString{ASCIIString}["CCAAGTGTAAGGGTGTGGA"]
AAAAGAAGAGAATACTTTG	SubString{ASCIIString}["AAAGAAGAGAATACTTTGA"]
GGTCATTACAGCCGATATA	SubString{ASCIIString}["GTCATTACAGCCGATATAC"]
GCGGTTTCTGGCGCGCGGT	SubString{ASCIIString}["CGGTTTCTGGCGCGCGGTT"]
GGCAGTTCATCTCCCTGGC	SubString{ASCIIString}["GCAGTTCATCTCCCTGGCC"]
GAGAAGTAACATCTTATCT	SubString{ASCIIString}["AGAAGTAACATCTTATCTG"]
GCCGGTAAACTCCAAACCT	SubString{ASCIIString}["CCGGTAAACTCCAAACCTG"]
GGCTCTTCATGACCTGGGT	SubString{ASCIIString}["GCTCTTCATGACCTGGGTT"]
CACACAGCCACAGACACCA	SubString{ASCIIString}["ACACAGCCACAGACACCAA"]
CAGATTCGTAGACGTTCAA	SubString{ASCIIString}["AGATTCGTAGACGTTCAAC"]
CTGATGGGTTTGACACGAG	SubString{ASCIIString}["TGATGGGTTTGACACGAGA"]
AGAAATGATCACCCCGTGT	SubString{ASCIIString}["GAAATGATCACCCCGTGTT"]
AATCTCGCCCTCTCTGGTT	SubString{ASCIIString}["ATCTCGCCCTCTCTGGTTC"]
CAGCGCGTGGGAGATGCCG	SubString{ASCIIString}["AGCGCGTGGGAGATGCCGC"]
AGGCCGAACCCACTAGTCC	SubString{ASCIIString}["GGCCGAACCCACTAGTCCG"]
ATCGTGCAACCAAGTGTAA	SubString{ASCIIString}["TCGTGCAACCAAGTGTAAG"]
TGTGCGTTCACATGGTCAT	SubString{ASCIIString}["GTGCGTTCACATGGTCATT"]
TTGAATCCGGTACAGGTTA	SubString{ASCIIString}["TGAATCCGGTACAGGTTAA"]
TATCTAACCGCCCCTGGCG	SubString{ASCIIString}["ATCTAACCGCCCCTGGCGA"]
CATCTACGGCATTGTCTAG	SubString{ASCIIString}["ATCTACGGCATTGTCTAGT"]
GGGTTCATGACCAGGGCCT	SubString{ASCIIString}["GGTTCATGACCAGGGCCTG"]
AGCTGACAGCGCGTGGGAG	SubString{ASCIIString}["GCTGACAGCGCGTGGGAGA"]
TAAGCAACATTATCAAATC	SubString{ASCIIString}["AAGCAACATTATCAAATCC"]
GTAACATCTTATCTGCTTT	SubString{ASCIIString}["TAACATCTTATCTGCTTTC"]
TGGAGCACCTCGCGCGGTT	SubString{ASCIIString}["GGAGCACCTCGCGCGGTTC"]
TGATCCTCTTTTAATAATA	SubString{ASCIIString}["GATCCTCTTTTAATAATAC"]
TCGACAGTTAGCAACAAAA	SubString{ASCIIString}["CGACAGTTAGCAACAAAAA"]
AGCGATACTTTCACACCGT	SubString{ASCIIString}["GCGATACTTTCACACCGTG"]
TCCCTGTTCGGCCGATTAA	SubString{ASCIIString}["CCCTGTTCGGCCGATTAAG"]
GCAACATTATCAAATCCGG	SubString{ASCIIString}["CAACATTATCAAATCCGGG"]
GCCATGAGAGCTGACAGCG	SubString{ASCIIString}["CCATGAGAGCTGACAGCGC"]
GTCAGCAATAGTCTAAGCG	SubString{ASCIIString}["TCAGCAATAGTCTAAGCGC"]
TCGCCCTATATGCAGTGCG	SubString{ASCIIString}["CGCCCTATATGCAGTGCGT"]
TCGGCCGATTAAGTAAGTT	SubString{ASCIIString}["CGGCCGATTAAGTAAGTTT"]
GATGCCGCCATCTACGGCA	SubString{ASCIIString}["ATGCCGCCATCTACGGCAT"]
ACAAAAATGTTGGACCCTA	SubString{ASCIIString}["CAAAAATGTTGGACCCTAT"]
TACGTCCGAAAATCGCCAA	SubString{ASCIIString}["ACGTCCGAAAATCGCCAAA"]
GCAGCTGGAAGTTTCACTA	SubString{ASCIIString}["CAGCTGGAAGTTTCACTAA"]
AGTCTTTCCGGAAGGCAGT	SubString{ASCIIString}["GTCTTTCCGGAAGGCAGTT"]
AGCACCAGCCAGTTCTCCT	SubString{ASCIIString}["GCACCAGCCAGTTCTCCTT"]
CGCGCGGTTGGGGGCGCTT	SubString{ASCIIString}["GCGCGGTTGGGGGCGCTTT"]
GGTAAACTCCAAACCTGAA	SubString{ASCIIString}["GTAAACTCCAAACCTGAAT"]
GTGCTGGCTAGCGTGAAAA	SubString{ASCIIString}["TGCTGGCTAGCGTGAAAAA"]
TTTTGGCGGACTCCTGCCT	SubString{ASCIIString}["TTTGGCGGACTCCTGCCTT"]
GCGGGCTTGCGCATCATTC	SubString{ASCIIString}["CGGGCTTGCGCATCATTCC"]
GGGTTTGACACGAGATACA	SubString{ASCIIString}["GGTTTGACACGAGATACAT"]
AACATCTTATCTGCTTTCA	SubString{ASCIIString}["ACATCTTATCTGCTTTCAC"]
ACCCGGTCCGAAAATCGCC	SubString{ASCIIString}["CCCGGTCCGAAAATCGCCA"]
GCGTTCGACAGTTAGCAAC	SubString{ASCIIString}["CGTTCGACAGTTAGCAACA"]
ACTTTGATTCCGTGACTCG	SubString{ASCIIString}["CTTTGATTCCGTGACTCGT"]
ACGGTAGCGCGAATTGAGG	SubString{ASCIIString}["CGGTAGCGCGAATTGAGGC"]
GCAGTCATACTGGACATGG	SubString{ASCIIString}["CAGTCATACTGGACATGGC"]
ACAAGGTCCTAGGACCGTC	SubString{ASCIIString}["CAAGGTCCTAGGACCGTCT"]
ATGTTGGACCCTATCCGTG	SubString{ASCIIString}["TGTTGGACCCTATCCGTGG"]
TCATTCCCTTTATATGAGC	SubString{ASCIIString}["CATTCCCTTTATATGAGCA"]
CTTTAGTCTTTCCGGAAGG	SubString{ASCIIString}["TTTAGTCTTTCCGGAAGGC"]
TTCTTAGATAATCGCGCGC	SubString{ASCIIString}["TCTTAGATAATCGCGCGCA"]
TCTAAGCGCTACCGTCGTC	SubString{ASCIIString}["CTAAGCGCTACCGTCGTCC"]
TCGCGCCCACATCTAGGGA	SubString{ASCIIString}["CGCGCCCACATCTAGGGAC"]
AACTTATTTTGGCCAATGC	SubString{ASCIIString}["ACTTATTTTGGCCAATGCA"]
TATCGGTTGAAGACATTTT	SubString{ASCIIString}["ATCGGTTGAAGACATTTTC"]
TAGCGCGAATTGAGGCCGA	SubString{ASCIIString}["AGCGCGAATTGAGGCCGAA"]
GTCCGGACCCTGCAACCCC	SubString{ASCIIString}["TCCGGACCCTGCAACCCCG"]
GCGAACGACGCGGGCTTGC	SubString{ASCIIString}["CGAACGACGCGGGCTTGCG"]
CGAAAATCGCCAAATACGA	SubString{ASCIIString}["GAAAATCGCCAAATACGAT"]
ACGCTGAGCAAAATATGGG	SubString{ASCIIString}["CGCTGAGCAAAATATGGGG"]
CAATTCTTAGATAATCGCG	SubString{ASCIIString}["AATTCTTAGATAATCGCGC"]
TGTCTATACTTATATTCTC	SubString{ASCIIString}["GTCTATACTTATATTCTCG"]
TTGCGTTCGACAGTTAGCA	SubString{ASCIIString}["TGCGTTCGACAGTTAGCAA"]
AGTCCTCCATAATCGGAGA	SubString{ASCIIString}["GTCCTCCATAATCGGAGAC"]
AGACGTTCAACTTTTGGTG	SubString{ASCIIString}["GACGTTCAACTTTTGGTGA"]
GGCAGTCATACTGGACATG	SubString{ASCIIString}["GCAGTCATACTGGACATGG"]
TGGGGACATATCTAACCGC	SubString{ASCIIString}["GGGGACATATCTAACCGCC"]
TCGCCAAATGGCAAAAAGC	SubString{ASCIIString}["CGCCAAATGGCAAAAAGCC"]
CGCCCATTTTCTTCGGTAT	SubString{ASCIIString}["GCCCATTTTCTTCGGTATT"]
TGTTATAGTCCTTTAGTCT	SubString{ASCIIString}["GTTATAGTCCTTTAGTCTT"]
ATGCAGCACCAGCCAGTTC	SubString{ASCIIString}["TGCAGCACCAGCCAGTTCT"]
CGATACTTTCACACCGTGT	SubString{ASCIIString}["GATACTTTCACACCGTGTT"]
AGTAACCATGCCGACCCCA	SubString{ASCIIString}["GTAACCATGCCGACCCCAG"]
TAGGAGGAGAAGTAACCAC	SubString{ASCIIString}["AGGAGGAGAAGTAACCACT"]
GGGGACATATCTAACCGCC	SubString{ASCIIString}["GGGACATATCTAACCGCCC"]
TTATCATAGAGGCTTATTT	SubString{ASCIIString}["TATCATAGAGGCTTATTTT"]
GCGGACTCCTGCCTTCATC	SubString{ASCIIString}["CGGACTCCTGCCTTCATCT"]
AGCAACATTATCAAATCCG	SubString{ASCIIString}["GCAACATTATCAAATCCGG"]
CTTATGAGTGTATGCTGCC	SubString{ASCIIString}["TTATGAGTGTATGCTGCCA"]
AACGACGCGGGCTTGCGCA	SubString{ASCIIString}["ACGACGCGGGCTTGCGCAT"]
TACCTTAGTCCGAAAATCG	SubString{ASCIIString}["ACCTTAGTCCGAAAATCGC"]
AGTTCATCTCCCTGGCCCA	SubString{ASCIIString}["GTTCATCTCCCTGGCCCAC"]
AAATCGTGCAACCAAGTGT	SubString{ASCIIString}["AATCGTGCAACCAAGTGTA"]
TCTGACCTAATATAGTCCG	SubString{ASCIIString}["CTGACCTAATATAGTCCGG"]
TCGCTAAGCAACATTATCA	SubString{ASCIIString}["CGCTAAGCAACATTATCAA"]
AACCCACTAGTCCGGACCC	SubString{ASCIIString}["ACCCACTAGTCCGGACCCT"]
GCCAGTTCTCCTTACTTGA	SubString{ASCIIString}["CCAGTTCTCCTTACTTGAG"]
CCTGTTCGGCCGATTAAGT	SubString{ASCIIString}["CTGTTCGGCCGATTAAGTA"]
CGCTTACCTGAATGGATGT	SubString{ASCIIString}["GCTTACCTGAATGGATGTC"]
TACTTGAGACCGCCAGTTA	SubString{ASCIIString}["ACTTGAGACCGCCAGTTAG"]
TGTTTAGGCCTCGAAAAAC	SubString{ASCIIString}["GTTTAGGCCTCGAAAAACC"]
AACCTGAATCGGGAGGTGC	SubString{ASCIIString}["ACCTGAATCGGGAGGTGCT"]
TGGTCATTTAGACAGATGT	SubString{ASCIIString}["GGTCATTTAGACAGATGTC"]
CCAATCTATACGTCCGAAA	SubString{ASCIIString}["CAATCTATACGTCCGAAAA"]
GTAAAGCGGTTTCTGGCGC	SubString{ASCIIString}["TAAAGCGGTTTCTGGCGCG"]
GTTGCTGCGGGTCGAGTCG	SubString{ASCIIString}["TTGCTGCGGGTCGAGTCGC"]
CCCTTTATATGAGCACGGA	SubString{ASCIIString}["CCTTTATATGAGCACGGAA"]
CGCATGGGGACATATCTAA	SubString{ASCIIString}["GCATGGGGACATATCTAAC"]
AGGAGAAGTAACCATGCCG	SubString{ASCIIString}["GGAGAAGTAACCATGCCGA"]
GATTTACTAAAGCTAGCCA	SubString{ASCIIString}["ATTTACTAAAGCTAGCCAT"]
TTCAATTGATCCTCTTTTA	SubString{ASCIIString}["TCAATTGATCCTCTTTTAA"]
CCATCTAAATCGTGCAACC	SubString{ASCIIString}["CATCTAAATCGTGCAACCA"]
ACATTCAGTGTGAGGCTTA	SubString{ASCIIString}["CATTCAGTGTGAGGCTTAT"]
AAGTAACCATGCCGACCCC	SubString{ASCIIString}["AGTAACCATGCCGACCCCA"]
TTATCAACGCCCATTTTCT	SubString{ASCIIString}["TATCAACGCCCATTTTCTT"]
ATCTGATGGGTTTGACACG	SubString{ASCIIString}["TCTGATGGGTTTGACACGA"]
ACCTAATATAGTCCGGAAG	SubString{ASCIIString}["CCTAATATAGTCCGGAAGA"]
AGCAACAAAAAGAAGAGAA	SubString{ASCIIString}["GCAACAAAAAGAAGAGAAT"]
AGTCTACGTTAGGAGTGTC	SubString{ASCIIString}["GTCTACGTTAGGAGTGTCC"]
ATCTGCTTTCACCACAGCG	SubString{ASCIIString}["TCTGCTTTCACCACAGCGA"]
TTTCGCAGCTGGAAGTTTC	SubString{ASCIIString}["TTCGCAGCTGGAAGTTTCA"]
GAGTACAAAAATGTTGGAC	SubString{ASCIIString}["AGTACAAAAATGTTGGACC"]
TATACTTATATTCTCGTCG	SubString{ASCIIString}["ATACTTATATTCTCGTCGT"]
GAAGAGAATACTTTGATTC	SubString{ASCIIString}["AAGAGAATACTTTGATTCC"]
GACCTTCCAGACAGACGCT	SubString{ASCIIString}["ACCTTCCAGACAGACGCTT"]
GGTAGCGCGAATTGAGGCC	SubString{ASCIIString}["GTAGCGCGAATTGAGGCCG"]
ATTCACGGTAGCGCGAATT	SubString{ASCIIString}["TTCACGGTAGCGCGAATTG"]
TGATTATATCGGTTGAAGA	SubString{ASCIIString}["GATTATATCGGTTGAAGAC"]
CTTTTGGTGACTTAACAAG	SubString{ASCIIString}["TTTTGGTGACTTAACAAGA"]
CTAAGCGACTTATCATAGA	SubString{ASCIIString}["TAAGCGACTTATCATAGAG"]
CATGACCAGGGCCTGTTCG	SubString{ASCIIString}["ATGACCAGGGCCTGTTCGC"]
CGGTCAACTGGGAAGTCGT	SubString{ASCIIString}["GGTCAACTGGGAAGTCGTG"]
AATTGATCCTCTTTTAATA	SubString{ASCIIString}["ATTGATCCTCTTTTAATAA"]
AGTTCTCCTTACTTGAGAC	SubString{ASCIIString}["GTTCTCCTTACTTGAGACC"]
ATGCCGACCCCAGCTCGCG	SubString{ASCIIString}["TGCCGACCCCAGCTCGCGC"]
CATGCCGACCCCAGCTCGC	SubString{ASCIIString}["ATGCCGACCCCAGCTCGCG"]
TGATCACCCCGTGTTGCTG	SubString{ASCIIString}["GATCACCCCGTGTTGCTGC"]
AAATGTTGGACCCTATCCG	SubString{ASCIIString}["AATGTTGGACCCTATCCGT"]
AGGAGAAGTAACCGCTTGC	SubString{ASCIIString}["GGAGAAGTAACCGCTTGCG"]
CGCAGCTGGAAGTTTCACT	SubString{ASCIIString}["GCAGCTGGAAGTTTCACTA"]
TACCCTGCGCGGTCAACTG	SubString{ASCIIString}["ACCCTGCGCGGTCAACTGG"]
TTCACGGTAGCGCGAATTG	SubString{ASCIIString}["TCACGGTAGCGCGAATTGA"]
TGAGCAAAATATGGGGCCT	SubString{ASCIIString}["GAGCAAAATATGGGGCCTT"]
TAGGAGGAGAAGTAACATC	SubString{ASCIIString}["AGGAGGAGAAGTAACATCT"]
GGCCTTATGAGTGTATGCT	SubString{ASCIIString}["GCCTTATGAGTGTATGCTG"]
CTACTCGCCCTATATGCAG	SubString{ASCIIString}["TACTCGCCCTATATGCAGT"]
AAATATGGGGCCTTATGAG	SubString{ASCIIString}["AATATGGGGCCTTATGAGT"]
TATTTTGGGCCAGAACGGC	SubString{ASCIIString}["ATTTTGGGCCAGAACGGCC"]
TGAGGCTAGATTTACTAAA	SubString{ASCIIString}["GAGGCTAGATTTACTAAAG"]
TTAGACAGATGTCAAGCAC	SubString{ASCIIString}["TAGACAGATGTCAAGCACC"]
AGTGCGTAGGGGGTATGTG	SubString{ASCIIString}["GTGCGTAGGGGGTATGTGG"]
AGACACCAACCTCTGCACT	SubString{ASCIIString}["GACACCAACCTCTGCACTG"]
GCCAAATGGCAAAAAGCCA	SubString{ASCIIString}["CCAAATGGCAAAAAGCCAT"]
AGATTCGTAGACGTTCAAC	SubString{ASCIIString}["GATTCGTAGACGTTCAACT"]
ACCTGTTTGAAAAGTTCAT	SubString{ASCIIString}["CCTGTTTGAAAAGTTCATG"]
TTCGACAGTTAGCAACAAA	SubString{ASCIIString}["TCGACAGTTAGCAACAAAA"]
GAGCACGGAAAGTCAGTGG	SubString{ASCIIString}["AGCACGGAAAGTCAGTGGA"]
TTGCAAAATCTCGCCCTCT	SubString{ASCIIString}["TGCAAAATCTCGCCCTCTC"]
TGTTGGACCCTATCCGTGG	SubString{ASCIIString}["GTTGGACCCTATCCGTGGG"]
CAGATGGCTGAATGTTCCT	SubString{ASCIIString}["AGATGGCTGAATGTTCCTA"]
GCATACAGCCCTAATAGCT	SubString{ASCIIString}["CATACAGCCCTAATAGCTG"]
CACCACAACAAGAGAAACA	SubString{ASCIIString}["ACCACAACAAGAGAAACAC"]
ATCTTTAAACAGTGTGCAT	SubString{ASCIIString}["TCTTTAAACAGTGTGCATA"]
GGCGGACTCCTGCCTTCAT	SubString{ASCIIString}["GCGGACTCCTGCCTTCATC"]
CCAGCTCGCGCCCACATCT	SubString{ASCIIString}["CAGCTCGCGCCCACATCTA"]
GAAGTCGTGCACAGTAGTC	SubString{ASCIIString}["AAGTCGTGCACAGTAGTCC"]
GCCTGTTCGCAGCCCTACC	SubString{ASCIIString}["CCTGTTCGCAGCCCTACCC"]
AGCCATGTAGGAGGAGAAG	SubString{ASCIIString}["GCCATGTAGGAGGAGAAGT"]
CCTTGTCCATCTAAATCGT	SubString{ASCIIString}["CTTGTCCATCTAAATCGTG"]
TTCTCCTTACTTGAGACCG	SubString{ASCIIString}["TCTCCTTACTTGAGACCGC"]
ATGGCACCTTTATTATCGG	SubString{ASCIIString}["TGGCACCTTTATTATCGGC"]
TTTAAGGTAATCGCCCGAG	SubString{ASCIIString}["TTAAGGTAATCGCCCGAGT"]
AAAAATGTTGGACCCTATC	SubString{ASCIIString}["AAAATGTTGGACCCTATCC"]
CACGCTGAGCAAAATATGG	SubString{ASCIIString}["ACGCTGAGCAAAATATGGG"]
GACAGCGCGTGGGAGATGC	SubString{ASCIIString}["ACAGCGCGTGGGAGATGCC"]
CTTATCATAGAGGCTTATT	SubString{ASCIIString}["TTATCATAGAGGCTTATTT"]
TTCGCGGGCATGTAGGAGG	SubString{ASCIIString}["TCGCGGGCATGTAGGAGGA"]
GACTTAACAAGAAATGATC	SubString{ASCIIString}["ACTTAACAAGAAATGATCA"]
CAACTTTTGGTGACTTAAC	SubString{ASCIIString}["AACTTTTGGTGACTTAACA"]
AAGTGTAAGGGTGTGGAGC	SubString{ASCIIString}["AGTGTAAGGGTGTGGAGCA"]
GTTCATCTCCCTGGCCCAC	SubString{ASCIIString}["TTCATCTCCCTGGCCCACC"]
GAGAATACTTTGATTCCGT	SubString{ASCIIString}["AGAATACTTTGATTCCGTG"]
CAATGATTCGGGCGACACC	SubString{ASCIIString}["AATGATTCGGGCGACACCA"]
ACTGTGGTTGCAAAATCTC	SubString{ASCIIString}["CTGTGGTTGCAAAATCTCG"]
GACCCTATCCGTGGGCAAC	SubString{ASCIIString}["ACCCTATCCGTGGGCAACT"]
GCCCCTGGCGAACCTAGGC	SubString{ASCIIString}["CCCCTGGCGAACCTAGGCA"]
ACTTATCATAGAGGCTTAT	SubString{ASCIIString}["CTTATCATAGAGGCTTATT"]
CACCTATGACCTTCCAGAC	SubString{ASCIIString}["ACCTATGACCTTCCAGACA"]
TAAATCGTGCAACCAAGTG	SubString{ASCIIString}["AAATCGTGCAACCAAGTGT"]
TAGTCCTCCATAATCGGAG	SubString{ASCIIString}["AGTCCTCCATAATCGGAGA"]
GTGTCCACCTATGACCTTC	SubString{ASCIIString}["TGTCCACCTATGACCTTCC"]
TTAGTTTCGCGCTTACCTG	SubString{ASCIIString}["TAGTTTCGCGCTTACCTGA"]
GCTTTCAAAGCCTTGTCCA	SubString{ASCIIString}["CTTTCAAAGCCTTGTCCAT"]
TTGAGACCGCCAGTTAGTT	SubString{ASCIIString}["TGAGACCGCCAGTTAGTTT"]
GCCGCATGGGGACATATCT	SubString{ASCIIString}["CCGCATGGGGACATATCTA"]
AACCATGCCGACCCCAGCT	SubString{ASCIIString}["ACCATGCCGACCCCAGCTC"]
TCCGAAAATCGCCAAATCA	SubString{ASCIIString}["CCGAAAATCGCCAAATCAC"]
TTGCGCATCATTCCCTTTA	SubString{ASCIIString}["TGCGCATCATTCCCTTTAT"]
GAGGCTAGATTTACTAAAG	SubString{ASCIIString}["AGGCTAGATTTACTAAAGC"]
ATCGCCAAATCACCAACAG	SubString{ASCIIString}["TCGCCAAATCACCAACAGG"]
GTAGGGGGTATGTGGAACT	SubString{ASCIIString}["TAGGGGGTATGTGGAACTT"]
TCTCCTTACTTGAGACCGC	SubString{ASCIIString}["CTCCTTACTTGAGACCGCC"]
CCACAATGATTCGGGCGAC	SubString{ASCIIString}["CACAATGATTCGGGCGACA"]
CGCTTGTGCGTTCACATGG	SubString{ASCIIString}["GCTTGTGCGTTCACATGGT"]
GCGGTTGGGGGCGCTTTCA	SubString{ASCIIString}["CGGTTGGGGGCGCTTTCAA"]
TTCGCCACCCACAATGATT	SubString{ASCIIString}["TCGCCACCCACAATGATTC"]
ATTCTCGTCGTGAGGCTAG	SubString{ASCIIString}["TTCTCGTCGTGAGGCTAGA"]
GGCAACTTGTTATAGTCCT	SubString{ASCIIString}["GCAACTTGTTATAGTCCTT"]
CATGGTCATTTAGACAGAT	SubString{ASCIIString}["ATGGTCATTTAGACAGATG"]
GTGTCGCTAAGCAACATTA	SubString{ASCIIString}["TGTCGCTAAGCAACATTAT"]
GGACTCCTGCCTTCATCTT	SubString{ASCIIString}["GACTCCTGCCTTCATCTTT"]
CAGTAGGCGGAGTTCTAAG	SubString{ASCIIString}["AGTAGGCGGAGTTCTAAGC"]
CGTGTCAGCAATAGTCTAA	SubString{ASCIIString}["GTGTCAGCAATAGTCTAAG"]
GTAAGGGTGTGGAGCACCT	SubString{ASCIIString}["TAAGGGTGTGGAGCACCTC"]
CACAGCGAACGACGCGGGC	SubString{ASCIIString}["ACAGCGAACGACGCGGGCT"]
ACATCTTATCTGCTTTCAC	SubString{ASCIIString}["CATCTTATCTGCTTTCACC"]
TATGTGGAACTTATTTTGG	SubString{ASCIIString}["ATGTGGAACTTATTTTGGC"]
CTATCGGCTCTTCATGACC	SubString{ASCIIString}["TATCGGCTCTTCATGACCT"]
AATCGGAGACATGTTACCA	SubString{ASCIIString}["ATCGGAGACATGTTACCAG"]
CAGCCGATATACGGGTCTG	SubString{ASCIIString}["AGCCGATATACGGGTCTGC"]
CTGTGTACCCTGCGCGGTC	SubString{ASCIIString}["TGTGTACCCTGCGCGGTCA"]
TGTGGAGCACCTCGCGCGG	SubString{ASCIIString}["GTGGAGCACCTCGCGCGGT"]
CCATAATCGGAGACATGTT	SubString{ASCIIString}["CATAATCGGAGACATGTTA"]
TAAAGCTAGCCATGAGAGC	SubString{ASCIIString}["AAAGCTAGCCATGAGAGCT"]
ACGCTTGAAAAGATGCAGT	SubString{ASCIIString}["CGCTTGAAAAGATGCAGTA"]
CTGTTCGGCCGATTAAGTA	SubString{ASCIIString}["TGTTCGGCCGATTAAGTAA"]
TGGTACCTTAGTCCGAAAA	SubString{ASCIIString}["GGTACCTTAGTCCGAAAAT"]
ATCGCGCGCAAGTTTGCAT	SubString{ASCIIString}["TCGCGCGCAAGTTTGCATT"]
TCATTCAATTCTTAGATAA	SubString{ASCIIString}["CATTCAATTCTTAGATAAT"]
AGTTTTCGCAGCTGGAAGT	SubString{ASCIIString}["GTTTTCGCAGCTGGAAGTT"]
ACCTATGACCTTCCAGACA	SubString{ASCIIString}["CCTATGACCTTCCAGACAG"]
AGGGACTCATTCAATTCTT	SubString{ASCIIString}["GGGACTCATTCAATTCTTA"]
CACGGTAGCGCGAATTGAG	SubString{ASCIIString}["ACGGTAGCGCGAATTGAGG"]
TTTCACCACAGCGAACGAC	SubString{ASCIIString}["TTCACCACAGCGAACGACG"]
CTAGGACCGTCTCAGGAAG	SubString{ASCIIString}["TAGGACCGTCTCAGGAAGT"]
GGAGAAGTAACCATGCCGA	SubString{ASCIIString}["GAGAAGTAACCATGCCGAC"]
ATCACCAACAGGCATGTAG	SubString{ASCIIString}["TCACCAACAGGCATGTAGG"]
GAAGTTTCACTAATTTGTC	SubString{ASCIIString}["AAGTTTCACTAATTTGTCT"]
ATAGTCTAAGCGCTACCGT	SubString{ASCIIString}["TAGTCTAAGCGCTACCGTC"]
TGTTGTGGTCGTGTTTTGG	SubString{ASCIIString}["GTTGTGGTCGTGTTTTGGG"]
ACCCCAGCTCGCGCCCACA	SubString{ASCIIString}["CCCCAGCTCGCGCCCACAT"]
CCTGCAACCCCGGTTCGCT	SubString{ASCIIString}["CTGCAACCCCGGTTCGCTT"]
TGACCAGGGCCTGTTCGCA	SubString{ASCIIString}["GACCAGGGCCTGTTCGCAG"]
CATTTAGACAGATGTCAAG	SubString{ASCIIString}["ATTTAGACAGATGTCAAGC"]
GGTGCTGGCTAGCGTGAAA	SubString{ASCIIString}["GTGCTGGCTAGCGTGAAAA"]
GCTTGCGCATCATTCCCTT	SubString{ASCIIString}["CTTGCGCATCATTCCCTTT"]
AGAACGGCCCCTAGACTCC	SubString{ASCIIString}["GAACGGCCCCTAGACTCCG"]
TCCGTAGCCGCTCTATCGG	SubString{ASCIIString}["CCGTAGCCGCTCTATCGGC"]
TTCGCTTGTGCGTTCACAT	SubString{ASCIIString}["TCGCTTGTGCGTTCACATG"]
GAAAATCGCCAAATTGTTC	SubString{ASCIIString}["AAAATCGCCAAATTGTTCG"]
CAGATCCGAGGATCTGGTG	SubString{ASCIIString}["AGATCCGAGGATCTGGTGG"]
GTATGTGGAACTTATTTTG	SubString{ASCIIString}["TATGTGGAACTTATTTTGG"]
ACCCACAATGATTCGGGCG	SubString{ASCIIString}["CCCACAATGATTCGGGCGA"]
CTCGCCCTATATGCAGTGC	SubString{ASCIIString}["TCGCCCTATATGCAGTGCG"]
ATTCGGGCGACACCACAAC	SubString{ASCIIString}["TTCGGGCGACACCACAACA"]
AATTCACGGTAGCGCGAAT	SubString{ASCIIString}["ATTCACGGTAGCGCGAATT"]
CCGAACCCACTAGTCCGGA	SubString{ASCIIString}["CGAACCCACTAGTCCGGAC"]
CACCCCGTGTTGCTGCGGG	SubString{ASCIIString}["ACCCCGTGTTGCTGCGGGT"]
CCCGTGTTGCTGCGGGTCG	SubString{ASCIIString}["CCGTGTTGCTGCGGGTCGA"]
AGTGTGAGGCTTATCAACG	SubString{ASCIIString}["GTGTGAGGCTTATCAACGC"]
CCGGGCAGCCAACTAGTTC	SubString{ASCIIString}["CGGGCAGCCAACTAGTTCT"]
GGCTCAGGCGTGATCTGAT	SubString{ASCIIString}["GCTCAGGCGTGATCTGATG"]
CCCACCTGTTTGAAAAGTT	SubString{ASCIIString}["CCACCTGTTTGAAAAGTTC"]
TTTCTTCGGTATTCCGGCA	SubString{ASCIIString}["TTCTTCGGTATTCCGGCAT"]
GTCTCAGGAAGTCTACGTT	SubString{ASCIIString}["TCTCAGGAAGTCTACGTTA"]
TGCGTAGGGGGTATGTGGA	SubString{ASCIIString}["GCGTAGGGGGTATGTGGAA"]
CTTACTTGAGACCGCCAGT	SubString{ASCIIString}["TTACTTGAGACCGCCAGTT"]
TTTCACTAATTTGTCTTGA	SubString{ASCIIString}["TTCACTAATTTGTCTTGAA"]
GTGCGTACTGCGAATGTTT	SubString{ASCIIString}["TGCGTACTGCGAATGTTTT"]
CATGCCCTTTTGGCGGACT	SubString{ASCIIString}["ATGCCCTTTTGGCGGACTC"]
TATCCGTGGGCAACTTGTT	SubString{ASCIIString}["ATCCGTGGGCAACTTGTTA"]
CTCTTCATGACCTGGGTTG	SubString{ASCIIString}["TCTTCATGACCTGGGTTGC"]
TCGCCAAATCACCAACAGG	SubString{ASCIIString}["CGCCAAATCACCAACAGGC"]
GGGACATATCTAACCGCCC	SubString{ASCIIString}["GGACATATCTAACCGCCCC"]
TTTTCGCAGCTGGAAGTTT	SubString{ASCIIString}["TTTCGCAGCTGGAAGTTTC"]
CTTGAAAAGATGCAGTAGG	SubString{ASCIIString}["TTGAAAAGATGCAGTAGGC"]
AAAGATGCAGTAGGCGGAG	SubString{ASCIIString}["AAGATGCAGTAGGCGGAGT"]
GTTCGACAGTTAGCAACAA	SubString{ASCIIString}["TTCGACAGTTAGCAACAAA"]
ACTTATATTCTCGTCGTGA	SubString{ASCIIString}["CTTATATTCTCGTCGTGAG"]
TTGGCGGACTCCTGCCTTC	SubString{ASCIIString}["TGGCGGACTCCTGCCTTCA"]
GTTTCTGGCGCGCGGTTGG	SubString{ASCIIString}["TTTCTGGCGCGCGGTTGGG"]
GATCCGAGGATCTGGTGGC	SubString{ASCIIString}["ATCCGAGGATCTGGTGGCT"]
AGAGCTGACAGCGCGTGGG	SubString{ASCIIString}["GAGCTGACAGCGCGTGGGA"]
CTGCGGGTCGAGTCGCCGG	SubString{ASCIIString}["TGCGGGTCGAGTCGCCGGT"]
TGAGGCCGAACCCACTAGT	SubString{ASCIIString}["GAGGCCGAACCCACTAGTC"]
CAGCACCAGCCAGTTCTCC	SubString{ASCIIString}["AGCACCAGCCAGTTCTCCT"]
CCCATCTAGCAGTGTTTAG	SubString{ASCIIString}["CCATCTAGCAGTGTTTAGG"]
GACACCAACCTCTGCACTG	SubString{ASCIIString}["ACACCAACCTCTGCACTGT"]
GTCTGCATAGTTGAATCCG	SubString{ASCIIString}["TCTGCATAGTTGAATCCGG"]
GACTCCGAGCAGCGATACT	SubString{ASCIIString}["ACTCCGAGCAGCGATACTT"]
TCCGAGCAGCGATACTTTC	SubString{ASCIIString}["CCGAGCAGCGATACTTTCA"]
CCTGCCTTCATCTTTAAAC	SubString{ASCIIString}["CTGCCTTCATCTTTAAACA"]
AGTTCTGACCTAATATAGT	SubString{ASCIIString}["GTTCTGACCTAATATAGTC"]
TAGGAGGAGAAGTAACCGC	SubString{ASCIIString}["AGGAGGAGAAGTAACCGCT"]
CTGCATAGTTGAATCCGGT	SubString{ASCIIString}["TGCATAGTTGAATCCGGTA"]
GCAGTAGGCGGAGTTCTAA	SubString{ASCIIString}["CAGTAGGCGGAGTTCTAAG"]
GCGTGAAAAATTCACGGTA	SubString{ASCIIString}["CGTGAAAAATTCACGGTAG"]
TATGACCTTCCAGACAGAC	SubString{ASCIIString}["ATGACCTTCCAGACAGACG"]
GGAGGTGCTGGCTAGCGTG	SubString{ASCIIString}["GAGGTGCTGGCTAGCGTGA"]
AATATGGGGCCTTATGAGT	SubString{ASCIIString}["ATATGGGGCCTTATGAGTG"]
TATATCGGTTGAAGACATT	SubString{ASCIIString}["ATATCGGTTGAAGACATTT"]
GTGTGAGGCTTATCAACGC	SubString{ASCIIString}["TGTGAGGCTTATCAACGCC"]
AATCACCAACAGGCATGTA	SubString{ASCIIString}["ATCACCAACAGGCATGTAG"]
TGGAAGTTTCACTAATTTG	SubString{ASCIIString}["GGAAGTTTCACTAATTTGT"]
TCGCAGCCCTACCCGGTCC	SubString{ASCIIString}["CGCAGCCCTACCCGGTCCG"]
TTCATGACCAGGGCCTGTT	SubString{ASCIIString}["TCATGACCAGGGCCTGTTC"]
TTGCGACAAGGTCCTAGGA	SubString{ASCIIString}["TGCGACAAGGTCCTAGGAC"]
TGGGCAACTTGTTATAGTC	SubString{ASCIIString}["GGGCAACTTGTTATAGTCC"]
TCTACGTTAGGAGTGTCCA	SubString{ASCIIString}["CTACGTTAGGAGTGTCCAC"]
CCTGAATCGGGAGGTGCTG	SubString{ASCIIString}["CTGAATCGGGAGGTGCTGG"]
GAAAAACCAATCTATACGT	SubString{ASCIIString}["AAAAACCAATCTATACGTC"]
GGATCTGGTGGCTAGTAAA	SubString{ASCIIString}["GATCTGGTGGCTAGTAAAG"]
AAAATATGGGGCCTTATGA	SubString{ASCIIString}["AAATATGGGGCCTTATGAG"]
ATCGGCTCTTCATGACCTG	SubString{ASCIIString}["TCGGCTCTTCATGACCTGG"]
GGTTCCGTAGCCGCTCTAT	SubString{ASCIIString}["GTTCCGTAGCCGCTCTATC"]
CTTAGATAATCGCGCGCAA	SubString{ASCIIString}["TTAGATAATCGCGCGCAAG"]
GCCATCTACGGCATTGTCT	SubString{ASCIIString}["CCATCTACGGCATTGTCTA"]
CCAAATCACCAACAGGCAT	SubString{ASCIIString}["CAAATCACCAACAGGCATG"]
CTGGCGAACCTAGGCACCC	SubString{ASCIIString}["TGGCGAACCTAGGCACCCA"]
TCGGCTCTTCATGACCTGG	SubString{ASCIIString}["CGGCTCTTCATGACCTGGG"]
CAGCCAGTTCTCCTTACTT	SubString{ASCIIString}["AGCCAGTTCTCCTTACTTG"]
AGGTTAATGTGCGTACTGC	SubString{ASCIIString}["GGTTAATGTGCGTACTGCG"]
CTAGTCCGGACCCTGCAAC	SubString{ASCIIString}["TAGTCCGGACCCTGCAACC"]
CTCTTTTAATAATACAGAT	SubString{ASCIIString}["TCTTTTAATAATACAGATT"]
GCGACTTATCATAGAGGCT	SubString{ASCIIString}["CGACTTATCATAGAGGCTT"]
TGTATGCTGCCACACAGCC	SubString{ASCIIString}["GTATGCTGCCACACAGCCA"]
AAAATCTCGCCCTCTCTGG	SubString{ASCIIString}["AAATCTCGCCCTCTCTGGT"]
TTACAGCCGATATACGGGT	SubString{ASCIIString}["TACAGCCGATATACGGGTC"]
CTTATCTGCTTTCACCACA	SubString{ASCIIString}["TTATCTGCTTTCACCACAG"]
AGACATTTTCCCCTACGTT	SubString{ASCIIString}["GACATTTTCCCCTACGTTT"]
ATACAGCCCTAATAGCTGA	SubString{ASCIIString}["TACAGCCCTAATAGCTGAC"]
CATTATCAAATCCGGGCAG	SubString{ASCIIString}["ATTATCAAATCCGGGCAGC"]
TATCAAATCCGGGCAGCCA	SubString{ASCIIString}["ATCAAATCCGGGCAGCCAA"]
GTCATTTAGACAGATGTCA	SubString{ASCIIString}["TCATTTAGACAGATGTCAA"]
GCGTGATCTGATGGGTTTG	SubString{ASCIIString}["CGTGATCTGATGGGTTTGA"]
CATTCAATTCTTAGATAAT	SubString{ASCIIString}["ATTCAATTCTTAGATAATC"]
CTTTCAAAGCCTTGTCCAT	SubString{ASCIIString}["TTTCAAAGCCTTGTCCATC"]
GTTTTGATTATATCGGTTG	SubString{ASCIIString}["TTTTGATTATATCGGTTGA"]
AAGTCAGTGGAGTACAAAA	SubString{ASCIIString}["AGTCAGTGGAGTACAAAAA"]
CGTCCGAAAATCGCCAAAT	SubString{ASCIIString}["GTCCGAAAATCGCCAAATC"]
CTACGTTAGGAGTGTCCAC	SubString{ASCIIString}["TACGTTAGGAGTGTCCACC"]
TCCCCGTTGTTGTGGTCGT	SubString{ASCIIString}["CCCCGTTGTTGTGGTCGTG"]
ATTTTCTTCGGTATTCCGG	SubString{ASCIIString}["TTTTCTTCGGTATTCCGGC"]
CAGCAATAGTCTAAGCGCT	SubString{ASCIIString}["AGCAATAGTCTAAGCGCTA"]
CCACATCTAGGGACTCATT	SubString{ASCIIString}["CACATCTAGGGACTCATTC"]
AAACCAATCTATACGTCCG	SubString{ASCIIString}["AACCAATCTATACGTCCGA"]
GTCATGGGTTCATGACCAG	SubString{ASCIIString}["TCATGGGTTCATGACCAGG"]
TTTGGGGCTCAGGCGTGAT	SubString{ASCIIString}["TTGGGGCTCAGGCGTGATC"]
AAAACCAATCTATACGTCC	SubString{ASCIIString}["AAACCAATCTATACGTCCG"]
CTAAAGCTAGCCATGAGAG	SubString{ASCIIString}["TAAAGCTAGCCATGAGAGC"]
CACAGACACCAACCTCTGC	SubString{ASCIIString}["ACAGACACCAACCTCTGCA"]
CTTCATCTTTAAACAGTGT	SubString{ASCIIString}["TTCATCTTTAAACAGTGTG"]
TCCGGTACAGGTTAATGTG	SubString{ASCIIString}["CCGGTACAGGTTAATGTGC"]
GCGCGCAAGTTTGCATTCC	SubString{ASCIIString}["CGCGCAAGTTTGCATTCCA"]
CACCGTGTTTTGATTATAT	SubString{ASCIIString}["ACCGTGTTTTGATTATATC"]
GTAGCCGCTCTATCGGCTC	SubString{ASCIIString}["TAGCCGCTCTATCGGCTCT"]
TTGGGCCAGAACGGCCCCT	SubString{ASCIIString}["TGGGCCAGAACGGCCCCTA"]
AAGTTTGCATTCCACAGAT	SubString{ASCIIString}["AGTTTGCATTCCACAGATG"]
CCAACAGGCATGTAGGAGG	SubString{ASCIIString}["CAACAGGCATGTAGGAGGA"]
TTCTCGTCGTGAGGCTAGA	SubString{ASCIIString}["TCTCGTCGTGAGGCTAGAT"]
AATTCTTAGATAATCGCGC	SubString{ASCIIString}["ATTCTTAGATAATCGCGCG"]
CGCGGTTCTACGTGTCAGC	SubString{ASCIIString}["GCGGTTCTACGTGTCAGCA"]
AGGTGCTGGCTAGCGTGAA	SubString{ASCIIString}["GGTGCTGGCTAGCGTGAAA"]
GGAAGTCTACGTTAGGAGT	SubString{ASCIIString}["GAAGTCTACGTTAGGAGTG"]
CTGAGCAAAATATGGGGCC	SubString{ASCIIString}["TGAGCAAAATATGGGGCCT"]
GTTAATGTGCGTACTGCGA	SubString{ASCIIString}["TTAATGTGCGTACTGCGAA"]
TATGCTGCCACACAGCCAC	SubString{ASCIIString}["ATGCTGCCACACAGCCACA"]
TCTCGCCCTCTCTGGTTCC	SubString{ASCIIString}["CTCGCCCTCTCTGGTTCCG"]
CGACCCCAGCTCGCGCCCA	SubString{ASCIIString}["GACCCCAGCTCGCGCCCAC"]
CCCTAGACTCCGAGCAGCG	SubString{ASCIIString}["CCTAGACTCCGAGCAGCGA"]
TGACAGGGGCAGTCATACT	SubString{ASCIIString}["GACAGGGGCAGTCATACTG"]
AACCGCTTGCGACAAGGTC	SubString{ASCIIString}["ACCGCTTGCGACAAGGTCC"]
GGGCAGCCAACTAGTTCTG	SubString{ASCIIString}["GGCAGCCAACTAGTTCTGA"]
CCCTACCCGGTCCGAAAAT	SubString{ASCIIString}["CCTACCCGGTCCGAAAATC"]
CAAATCACCAACAGGCATG	SubString{ASCIIString}["AAATCACCAACAGGCATGT"]
ACTTGTTATAGTCCTTTAG	SubString{ASCIIString}["CTTGTTATAGTCCTTTAGT"]
CCACTAGTCCGGACCCTGC	SubString{ASCIIString}["CACTAGTCCGGACCCTGCA"]
CGTAGACGTTCAACTTTTG	SubString{ASCIIString}["GTAGACGTTCAACTTTTGG"]
GAGGAGAAGTAACATCTTA	SubString{ASCIIString}["AGGAGAAGTAACATCTTAT"]
TATGGGGCCTTATGAGTGT	SubString{ASCIIString}["ATGGGGCCTTATGAGTGTA"]
TTTCACACCGTGTTTTGAT	SubString{ASCIIString}["TTCACACCGTGTTTTGATT"]
TTTTGGGGCTCAGGCGTGA	SubString{ASCIIString}["TTTGGGGCTCAGGCGTGAT"]
TTTAGTCTTTCCGGAAGGC	SubString{ASCIIString}["TTAGTCTTTCCGGAAGGCA"]
ACCAATCTATACGTCCGAA	SubString{ASCIIString}["CCAATCTATACGTCCGAAA"]
CAGATGTCAAGCACCCATC	SubString{ASCIIString}["AGATGTCAAGCACCCATCT"]
GTGTTTTGGGGCTCAGGCG	SubString{ASCIIString}["TGTTTTGGGGCTCAGGCGT"]
TCGCAGCTGGAAGTTTCAC	SubString{ASCIIString}["CGCAGCTGGAAGTTTCACT"]
CACAACAAGAGAAACACGC	SubString{ASCIIString}["ACAACAAGAGAAACACGCT"]
CCATGAGAGCTGACAGCGC	SubString{ASCIIString}["CATGAGAGCTGACAGCGCG"]
CTTTCCGGAAGGCAGTTCA	SubString{ASCIIString}["TTTCCGGAAGGCAGTTCAT"]
TAAGGTAATCGCCCGAGTG	SubString{ASCIIString}["AAGGTAATCGCCCGAGTGT"]
GCCAACTAGTTCTGACCTA	SubString{ASCIIString}["CCAACTAGTTCTGACCTAA"]
ACAGCGCGTGGGAGATGCC	SubString{ASCIIString}["CAGCGCGTGGGAGATGCCG"]
GTCCTCCATAATCGGAGAC	SubString{ASCIIString}["TCCTCCATAATCGGAGACA"]
TCTCGTCGTGAGGCTAGAT	SubString{ASCIIString}["CTCGTCGTGAGGCTAGATT"]
ACTCCAAACCTGAATCGGG	SubString{ASCIIString}["CTCCAAACCTGAATCGGGA"]
GAGGGGTCATTACAGCCGA	SubString{ASCIIString}["AGGGGTCATTACAGCCGAT"]
GCCTTCATCTTTAAACAGT	SubString{ASCIIString}["CCTTCATCTTTAAACAGTG"]
TCTAACCGCCCCTGGCGAA	SubString{ASCIIString}["CTAACCGCCCCTGGCGAAC"]
ACCCTGCAACCCCGGTTCG	SubString{ASCIIString}["CCCTGCAACCCCGGTTCGC"]
CCCCGTTGTTGTGGTCGTG	SubString{ASCIIString}["CCCGTTGTTGTGGTCGTGT"]
GCATTCGCCACCCACAATG	SubString{ASCIIString}["CATTCGCCACCCACAATGA"]
AATACAGATTCGTAGACGT	SubString{ASCIIString}["ATACAGATTCGTAGACGTT"]
ATGTTCCTACTCGCCCTAT	SubString{ASCIIString}["TGTTCCTACTCGCCCTATA"]
TTCAGTGTGAGGCTTATCA	SubString{ASCIIString}["TCAGTGTGAGGCTTATCAA"]
CTATACGTCCGAAAATCGC	SubString{ASCIIString}["TATACGTCCGAAAATCGCC"]
TGTAGGAGGAGAAGTAACA	SubString{ASCIIString}["GTAGGAGGAGAAGTAACAT"]
CGAGCAGCGATACTTTCAC	SubString{ASCIIString}["GAGCAGCGATACTTTCACA"]
ACGATTATCACATGTAGGA	SubString{ASCIIString}["CGATTATCACATGTAGGAG"]
ATTATCAAATCCGGGCAGC	SubString{ASCIIString}["TTATCAAATCCGGGCAGCC"]
GCATTGTCTAGTTTTCGCA	SubString{ASCIIString}["CATTGTCTAGTTTTCGCAG"]
TACCGTCGTCCTTGTCATG	SubString{ASCIIString}["ACCGTCGTCCTTGTCATGG"]
CGACACCACAACAAGAGAA	SubString{ASCIIString}["GACACCACAACAAGAGAAA"]
TCAACGCCCATTTTCTTCG	SubString{ASCIIString}["CAACGCCCATTTTCTTCGG"]
GCTTGTGCGTTCACATGGT	SubString{ASCIIString}["CTTGTGCGTTCACATGGTC"]
CAATGCAGCACCAGCCAGT	SubString{ASCIIString}["AATGCAGCACCAGCCAGTT"]
ATACTTATATTCTCGTCGT	SubString{ASCIIString}["TACTTATATTCTCGTCGTG"]
TGCGAATGTTTTCAATTGA	SubString{ASCIIString}["GCGAATGTTTTCAATTGAT"]
TCTGATGGGTTTGACACGA	SubString{ASCIIString}["CTGATGGGTTTGACACGAG"]
CGGGCGACACCACAACAAG	SubString{ASCIIString}["GGGCGACACCACAACAAGA"]
CTGCGAATGTTTTCAATTG	SubString{ASCIIString}["TGCGAATGTTTTCAATTGA"]
TTATCAAATCCGGGCAGCC	SubString{ASCIIString}["TATCAAATCCGGGCAGCCA"]
AAGTTCATGGTACCTTAGT	SubString{ASCIIString}["AGTTCATGGTACCTTAGTC"]
ACAGCCACAGACACCAACC	SubString{ASCIIString}["CAGCCACAGACACCAACCT"]
GGCAGCCAACTAGTTCTGA	SubString{ASCIIString}["GCAGCCAACTAGTTCTGAC"]
GAGACCGCCAGTTAGTTTC	SubString{ASCIIString}["AGACCGCCAGTTAGTTTCG"]
CAGGCATGTAGGAGGAGAA	SubString{ASCIIString}["AGGCATGTAGGAGGAGAAG"]
AACTAGTTCTGACCTAATA	SubString{ASCIIString}["ACTAGTTCTGACCTAATAT"]
TAACCGCCCCTGGCGAACC	SubString{ASCIIString}["AACCGCCCCTGGCGAACCT"]
ATATACGGGTCTGCATAGT	SubString{ASCIIString}["TATACGGGTCTGCATAGTT"]
AAAGCTAGCCATGAGAGCT	SubString{ASCIIString}["AAGCTAGCCATGAGAGCTG"]
CCAGATCCGAGGATCTGGT	SubString{ASCIIString}["CAGATCCGAGGATCTGGTG"]
TCTATCGGCTCTTCATGAC	SubString{ASCIIString}["CTATCGGCTCTTCATGACC"]
GGCTAGTAAAGCGGTTTCT	SubString{ASCIIString}["GCTAGTAAAGCGGTTTCTG"]
TTTTAATAATACAGATTCG	SubString{ASCIIString}["TTTAATAATACAGATTCGT"]
AGCAAAATATGGGGCCTTA	SubString{ASCIIString}["GCAAAATATGGGGCCTTAT"]
TCCCCTACGTTTGCCGCAT	SubString{ASCIIString}["CCCCTACGTTTGCCGCATG"]
AGTAACCACTGTGTACCCT	SubString{ASCIIString}["GTAACCACTGTGTACCCTG"]
TGTTTTCAATTGATCCTCT	SubString{ASCIIString}["GTTTTCAATTGATCCTCTT"]
GCGCGGTCAACTGGGAAGT	SubString{ASCIIString}["CGCGGTCAACTGGGAAGTC"]
GCTGGAAGTTTCACTAATT	SubString{ASCIIString}["CTGGAAGTTTCACTAATTT"]
CCTAGGACCGTCTCAGGAA	SubString{ASCIIString}["CTAGGACCGTCTCAGGAAG"]
TCGGGCGACACCACAACAA	SubString{ASCIIString}["CGGGCGACACCACAACAAG"]
AGATACATTCAGTGTGAGG	SubString{ASCIIString}["GATACATTCAGTGTGAGGC"]
GCCCATTTTCTTCGGTATT	SubString{ASCIIString}["CCCATTTTCTTCGGTATTC"]
TAGATTTACTAAAGCTAGC	SubString{ASCIIString}["AGATTTACTAAAGCTAGCC"]
TGTCAAGCACCCATCTAGC	SubString{ASCIIString}["GTCAAGCACCCATCTAGCA"]
TTTATTATCGGCAATGCAG	SubString{ASCIIString}["TTATTATCGGCAATGCAGC"]
GTTCTGACCTAATATAGTC	SubString{ASCIIString}["TTCTGACCTAATATAGTCC"]
TAGCAGTGTTTAGGCCTCG	SubString{ASCIIString}["AGCAGTGTTTAGGCCTCGA"]
ATCTGGTGGCTAGTAAAGC	SubString{ASCIIString}["TCTGGTGGCTAGTAAAGCG"]
CCCGGTCCGAAAATCGCCA	SubString{ASCIIString}["CCGGTCCGAAAATCGCCAA"]
TGGTCGTGTTTTGGGGCTC	SubString{ASCIIString}["GGTCGTGTTTTGGGGCTCA"]
TAGTCCGAAAATCGCCAAA	SubString{ASCIIString}["AGTCCGAAAATCGCCAAAT"]
AGTCGTGCACAGTAGTCCT	SubString{ASCIIString}["GTCGTGCACAGTAGTCCTC"]
AGCCCTACCCGGTCCGAAA	SubString{ASCIIString}["GCCCTACCCGGTCCGAAAA"]
TAAGGGTGTGGAGCACCTC	SubString{ASCIIString}["AAGGGTGTGGAGCACCTCG"]
TTGGGGGCGCTTTCAAAGC	SubString{ASCIIString}["TGGGGGCGCTTTCAAAGCC"]
GGAGGAGAAGTAACATCTT	SubString{ASCIIString}["GAGGAGAAGTAACATCTTA"]
GGCATTGTCTAGTTTTCGC	SubString{ASCIIString}["GCATTGTCTAGTTTTCGCA"]
AAATCCGGGCAGCCAACTA	SubString{ASCIIString}["AATCCGGGCAGCCAACTAG"]
AGTAGGCGGAGTTCTAAGC	SubString{ASCIIString}["GTAGGCGGAGTTCTAAGCG"]
GGGCAGTCATACTGGACAT	SubString{ASCIIString}["GGCAGTCATACTGGACATG"]
GGACCCTGCAACCCCGGTT	SubString{ASCIIString}["GACCCTGCAACCCCGGTTC"]
CCCTAATAGCTGACAGGGG	SubString{ASCIIString}["CCTAATAGCTGACAGGGGC"]
AAATCGCCAAATACGATTA	SubString{ASCIIString}["AATCGCCAAATACGATTAT"]
CAGCCAACTAGTTCTGACC	SubString{ASCIIString}["AGCCAACTAGTTCTGACCT"]
CGCTTGAAAAGATGCAGTA	SubString{ASCIIString}["GCTTGAAAAGATGCAGTAG"]
TTACCTGAATGGATGTCCG	SubString{ASCIIString}["TACCTGAATGGATGTCCGA"]
TAAAGCGGTTTCTGGCGCG	SubString{ASCIIString}["AAAGCGGTTTCTGGCGCGC"]
TGTCGCTAAGCAACATTAT	SubString{ASCIIString}["GTCGCTAAGCAACATTATC"]
TTAGTCCGAAAATCGCCAA	SubString{ASCIIString}["TAGTCCGAAAATCGCCAAA"]
TGACTTAACAAGAAATGAT	SubString{ASCIIString}["GACTTAACAAGAAATGATC"]
CAGCCCTAATAGCTGACAG	SubString{ASCIIString}["AGCCCTAATAGCTGACAGG"]
TTTCAAAGCCTTGTCCATC	SubString{ASCIIString}["TTCAAAGCCTTGTCCATCT"]
TACTCGCCCTATATGCAGT	SubString{ASCIIString}["ACTCGCCCTATATGCAGTG"]
AGTACAAAAATGTTGGACC	SubString{ASCIIString}["GTACAAAAATGTTGGACCC"]
GCCACCCACAATGATTCGG	SubString{ASCIIString}["CCACCCACAATGATTCGGG"]
ACGGCCCCTAGACTCCGAG	SubString{ASCIIString}["CGGCCCCTAGACTCCGAGC"]
TGGCTAGTAAAGCGGTTTC	SubString{ASCIIString}["GGCTAGTAAAGCGGTTTCT"]
TGAGAGCTGACAGCGCGTG	SubString{ASCIIString}["GAGAGCTGACAGCGCGTGG"]
CTCCTTACTTGAGACCGCC	SubString{ASCIIString}["TCCTTACTTGAGACCGCCA"]
GCTTTCACCACAGCGAACG	SubString{ASCIIString}["CTTTCACCACAGCGAACGA"]
GTGGGCAACTTGTTATAGT	SubString{ASCIIString}["TGGGCAACTTGTTATAGTC"]
TCCGAAAATCGCCAAATAC	SubString{ASCIIString}["CCGAAAATCGCCAAATACG"]
TTGCATTCCACAGATGGCT	SubString{ASCIIString}["TGCATTCCACAGATGGCTG"]
TATCGGCTCTTCATGACCT	SubString{ASCIIString}["ATCGGCTCTTCATGACCTG"]
TAAGGTCCCCGTTGTTGTG	SubString{ASCIIString}["AAGGTCCCCGTTGTTGTGG"]
AATAGTCTAAGCGCTACCG	SubString{ASCIIString}["ATAGTCTAAGCGCTACCGT"]
CAAGAAATGATCACCCCGT	SubString{ASCIIString}["AAGAAATGATCACCCCGTG"]
ATAAGGTCCCCGTTGTTGT	SubString{ASCIIString}["TAAGGTCCCCGTTGTTGTG"]
ATTTTGGCCAATGCAAGTA	SubString{ASCIIString}["TTTTGGCCAATGCAAGTAA"]
TGTTCGCGGGCATGTAGGA	SubString{ASCIIString}["GTTCGCGGGCATGTAGGAG"]
CATTTTCTTCGGTATTCCG	SubString{ASCIIString}["ATTTTCTTCGGTATTCCGG"]
GAGTGTATGCTGCCACACA	SubString{ASCIIString}["AGTGTATGCTGCCACACAG"]
CTAGGCACCCACGGCATGC	SubString{ASCIIString}["TAGGCACCCACGGCATGCC"]
ACCACTGTGTACCCTGCGC	SubString{ASCIIString}["CCACTGTGTACCCTGCGCG"]
ACCGCCCCTGGCGAACCTA	SubString{ASCIIString}["CCGCCCCTGGCGAACCTAG"]
TAACCACTGTGTACCCTGC	SubString{ASCIIString}["AACCACTGTGTACCCTGCG"]
TGATCTGATGGGTTTGACA	SubString{ASCIIString}["GATCTGATGGGTTTGACAC"]
TGAGACCGCCAGTTAGTTT	SubString{ASCIIString}["GAGACCGCCAGTTAGTTTC"]
TATGCAGTGCGTAGGGGGT	SubString{ASCIIString}["ATGCAGTGCGTAGGGGGTA"]
CGCGCCCACATCTAGGGAC	SubString{ASCIIString}["GCGCCCACATCTAGGGACT"]
GTCCGAAAATCGCCAAATC	SubString{ASCIIString}["TCCGAAAATCGCCAAATCA"]
CCACACAGCCACAGACACC	SubString{ASCIIString}["CACACAGCCACAGACACCA"]
TCAGTGTGAGGCTTATCAA	SubString{ASCIIString}["CAGTGTGAGGCTTATCAAC"]
GTGGAGCACCTCGCGCGGT	SubString{ASCIIString}["TGGAGCACCTCGCGCGGTT"]
CCCTTTTGGCGGACTCCTG	SubString{ASCIIString}["CCTTTTGGCGGACTCCTGC"]
GAAAAGATGCAGTAGGCGG	SubString{ASCIIString}["AAAAGATGCAGTAGGCGGA"]
TCGGAGACATGTTACCAGA	SubString{ASCIIString}["CGGAGACATGTTACCAGAT"]
AGCGCGAATTGAGGCCGAA	SubString{ASCIIString}["GCGCGAATTGAGGCCGAAC"]
CAGACGCTTGAAAAGATGC	SubString{ASCIIString}["AGACGCTTGAAAAGATGCA"]
GCGTGGGAGATGCCGCCAT	SubString{ASCIIString}["CGTGGGAGATGCCGCCATC"]
TCTCTGGTTCCGTAGCCGC	SubString{ASCIIString}["CTCTGGTTCCGTAGCCGCT"]
GCCAGTTAGTTTCGCGCTT	SubString{ASCIIString}["CCAGTTAGTTTCGCGCTTA"]
ATGTGCGTACTGCGAATGT	SubString{ASCIIString}["TGTGCGTACTGCGAATGTT"]
AACAAGAAATGATCACCCC	SubString{ASCIIString}["ACAAGAAATGATCACCCCG"]
TCAATTCTTAGATAATCGC	SubString{ASCIIString}["CAATTCTTAGATAATCGCG"]
GCACCCATCTAGCAGTGTT	SubString{ASCIIString}["CACCCATCTAGCAGTGTTT"]
CGGCCCCTAGACTCCGAGC	SubString{ASCIIString}["GGCCCCTAGACTCCGAGCA"]
ATGCCGCCATCTACGGCAT	SubString{ASCIIString}["TGCCGCCATCTACGGCATT"]
CCCATTTTCTTCGGTATTC	SubString{ASCIIString}["CCATTTTCTTCGGTATTCC"]
GGGGCAGTCATACTGGACA	SubString{ASCIIString}["GGGCAGTCATACTGGACAT"]
GGCCCACCTGTTTGAAAAG	SubString{ASCIIString}["GCCCACCTGTTTGAAAAGT"]
TAATAAGGTCCCCGTTGTT	SubString{ASCIIString}["AATAAGGTCCCCGTTGTTG"]
TGTTTTGATTATATCGGTT	SubString{ASCIIString}["GTTTTGATTATATCGGTTG"]
CAGTAGTCCTCCATAATCG	SubString{ASCIIString}["AGTAGTCCTCCATAATCGG"]
CGTAGGGGGTATGTGGAAC	SubString{ASCIIString}["GTAGGGGGTATGTGGAACT"]
CCGCTCTATCGGCTCTTCA	SubString{ASCIIString}["CGCTCTATCGGCTCTTCAT"]
TTCACACCGTGTTTTGATT	SubString{ASCIIString}["TCACACCGTGTTTTGATTA"]
GAACGACGCGGGCTTGCGC	SubString{ASCIIString}["AACGACGCGGGCTTGCGCA"]
TACTAAAGCTAGCCATGAG	SubString{ASCIIString}["ACTAAAGCTAGCCATGAGA"]
CCTGCGCGGTCAACTGGGA	SubString{ASCIIString}["CTGCGCGGTCAACTGGGAA"]
GTGACTCGTGTCGCTAAGC	SubString{ASCIIString}["TGACTCGTGTCGCTAAGCA"]
TATTATCGGCAATGCAGCA	SubString{ASCIIString}["ATTATCGGCAATGCAGCAC"]
TGGACCCTATCCGTGGGCA	SubString{ASCIIString}["GGACCCTATCCGTGGGCAA"]
GCTACCGTCGTCCTTGTCA	SubString{ASCIIString}["CTACCGTCGTCCTTGTCAT"]
TAATAGCTGACAGGGGCAG	SubString{ASCIIString}["AATAGCTGACAGGGGCAGT"]
TACATTCAGTGTGAGGCTT	SubString{ASCIIString}["ACATTCAGTGTGAGGCTTA"]
GTTAGGAGTGTCCACCTAT	SubString{ASCIIString}["TTAGGAGTGTCCACCTATG"]
GTTTTGGGGCTCAGGCGTG	SubString{ASCIIString}["TTTTGGGGCTCAGGCGTGA"]
CGGAAAGTCAGTGGAGTAC	SubString{ASCIIString}["GGAAAGTCAGTGGAGTACA"]
AGACATGTTACCAGATCCG	SubString{ASCIIString}["GACATGTTACCAGATCCGA"]
AGGTCCCCGTTGTTGTGGT	SubString{ASCIIString}["GGTCCCCGTTGTTGTGGTC"]
TAATGTGCGTACTGCGAAT	SubString{ASCIIString}["AATGTGCGTACTGCGAATG"]
TTTGCATTCCACAGATGGC	SubString{ASCIIString}["TTGCATTCCACAGATGGCT"]
CGAAAATCGCCAAATCACC	SubString{ASCIIString}["GAAAATCGCCAAATCACCA"]
AACCAAGTGTAAGGGTGTG	SubString{ASCIIString}["ACCAAGTGTAAGGGTGTGG"]
CGTGCACAGTAGTCCTCCA	SubString{ASCIIString}["GTGCACAGTAGTCCTCCAT"]
TATCTGCTTTCACCACAGC	SubString{ASCIIString}["ATCTGCTTTCACCACAGCG"]
AAATTGTTCGCGGGCATGT	SubString{ASCIIString}["AATTGTTCGCGGGCATGTA"]
TCTGGCGCGCGGTTGGGGG	SubString{ASCIIString}["CTGGCGCGCGGTTGGGGGC"]
CTCTCTGGTTCCGTAGCCG	SubString{ASCIIString}["TCTCTGGTTCCGTAGCCGC"]
TTATCACATGTAGGAGGAG	SubString{ASCIIString}["TATCACATGTAGGAGGAGA"]
GATACTTTCACACCGTGTT	SubString{ASCIIString}["ATACTTTCACACCGTGTTT"]
ATCAACGCCCATTTTCTTC	SubString{ASCIIString}["TCAACGCCCATTTTCTTCG"]
GCAAAAAGCCATGTAGGAG	SubString{ASCIIString}["CAAAAAGCCATGTAGGAGG"]
GAATCCGGTACAGGTTAAT	SubString{ASCIIString}["AATCCGGTACAGGTTAATG"]
GGCCGAACCCACTAGTCCG	SubString{ASCIIString}["GCCGAACCCACTAGTCCGG"]
AAACAGTGTGCATACAGCC	SubString{ASCIIString}["AACAGTGTGCATACAGCCC"]
CCGGACCCTGCAACCCCGG	SubString{ASCIIString}["CGGACCCTGCAACCCCGGT"]
ATCTAGCAGTGTTTAGGCC	SubString{ASCIIString}["TCTAGCAGTGTTTAGGCCT"]
GTGGTTGCAAAATCTCGCC	SubString{ASCIIString}["TGGTTGCAAAATCTCGCCC"]
CTGGCGCGCGGTTGGGGGC	SubString{ASCIIString}["TGGCGCGCGGTTGGGGGCG"]
ATCTTATCTGCTTTCACCA	SubString{ASCIIString}["TCTTATCTGCTTTCACCAC"]
TTACTTGAGACCGCCAGTT	SubString{ASCIIString}["TACTTGAGACCGCCAGTTA"]
ACGAGATACATTCAGTGTG	SubString{ASCIIString}["CGAGATACATTCAGTGTGA"]
CTGGTGGCTAGTAAAGCGG	SubString{ASCIIString}["TGGTGGCTAGTAAAGCGGT"]
ATTAAGTAAGTTTAAGGTA	SubString{ASCIIString}["TTAAGTAAGTTTAAGGTAA"]
ACAGTGTGCATACAGCCCT	SubString{ASCIIString}["CAGTGTGCATACAGCCCTA"]
CGTGTTTTGGGGCTCAGGC	SubString{ASCIIString}["GTGTTTTGGGGCTCAGGCG"]
GATACATTCAGTGTGAGGC	SubString{ASCIIString}["ATACATTCAGTGTGAGGCT"]
AAGAGAAACACGCTGAGCA	SubString{ASCIIString}["AGAGAAACACGCTGAGCAA"]
GGGTCATTACAGCCGATAT	SubString{ASCIIString}["GGTCATTACAGCCGATATA"]
CTCGAAAAACCAATCTATA	SubString{ASCIIString}["TCGAAAAACCAATCTATAC"]
TGAGGCTTATCAACGCCCA	SubString{ASCIIString}["GAGGCTTATCAACGCCCAT"]
GGTCGAGTCGCCGGTAAAC	SubString{ASCIIString}["GTCGAGTCGCCGGTAAACT"]
AATGTTGGACCCTATCCGT	SubString{ASCIIString}["ATGTTGGACCCTATCCGTG"]
GCGCCCACATCTAGGGACT	SubString{ASCIIString}["CGCCCACATCTAGGGACTC"]
TGACCTGGGTTGCGTTCGA	SubString{ASCIIString}["GACCTGGGTTGCGTTCGAC"]
TTATTATCGGCAATGCAGC	SubString{ASCIIString}["TATTATCGGCAATGCAGCA"]
TGCTGGCTAGCGTGAAAAA	SubString{ASCIIString}["GCTGGCTAGCGTGAAAAAT"]
TGCGTTCGACAGTTAGCAA	SubString{ASCIIString}["GCGTTCGACAGTTAGCAAC"]
TTAGGCCTCGAAAAACCAA	SubString{ASCIIString}["TAGGCCTCGAAAAACCAAT"]
ATAGTCCTTTAGTCTTTCC	SubString{ASCIIString}["TAGTCCTTTAGTCTTTCCG"]
GTACAGGTTAATGTGCGTA	SubString{ASCIIString}["TACAGGTTAATGTGCGTAC"]
CTGACAGGGGCAGTCATAC	SubString{ASCIIString}["TGACAGGGGCAGTCATACT"]
TGCAAAATCTCGCCCTCTC	SubString{ASCIIString}["GCAAAATCTCGCCCTCTCT"]
GTACTGCGAATGTTTTCAA	SubString{ASCIIString}["TACTGCGAATGTTTTCAAT"]
CTCCAAACCTGAATCGGGA	SubString{ASCIIString}["TCCAAACCTGAATCGGGAG"]
GGTAATCGCCCGAGTGTCT	SubString{ASCIIString}["GTAATCGCCCGAGTGTCTA"]
AGGGGCAGTCATACTGGAC	SubString{ASCIIString}["GGGGCAGTCATACTGGACA"]
CTGGAGGGGTCATTACAGC	SubString{ASCIIString}["TGGAGGGGTCATTACAGCC"]
GCTTATTTTGGGCCAGAAC	SubString{ASCIIString}["CTTATTTTGGGCCAGAACG"]
GCCGATTAAGTAAGTTTAA	SubString{ASCIIString}["CCGATTAAGTAAGTTTAAG"]
CATAGTTGAATCCGGTACA	SubString{ASCIIString}["ATAGTTGAATCCGGTACAG"]
CAGTTAGTTTCGCGCTTAC	SubString{ASCIIString}["AGTTAGTTTCGCGCTTACC"]
GGAAAGTCAGTGGAGTACA	SubString{ASCIIString}["GAAAGTCAGTGGAGTACAA"]
GGGGGCGCTTTCAAAGCCT	SubString{ASCIIString}["GGGGCGCTTTCAAAGCCTT"]
TCACCAACAGGCATGTAGG	SubString{ASCIIString}["CACCAACAGGCATGTAGGA"]
CCACGGCATGCCCTTTTGG	SubString{ASCIIString}["CACGGCATGCCCTTTTGGC"]
GAGATGCCGCCATCTACGG	SubString{ASCIIString}["AGATGCCGCCATCTACGGC"]
ATTGTTCGCGGGCATGTAG	SubString{ASCIIString}["TTGTTCGCGGGCATGTAGG"]
TGGTTGCAAAATCTCGCCC	SubString{ASCIIString}["GGTTGCAAAATCTCGCCCT"]
GCGATACTTTCACACCGTG	SubString{ASCIIString}["CGATACTTTCACACCGTGT"]
GTTCGCAGCCCTACCCGGT	SubString{ASCIIString}["TTCGCAGCCCTACCCGGTC"]
GAGCACCTCGCGCGGTTCT	SubString{ASCIIString}["AGCACCTCGCGCGGTTCTA"]
AGTAAAGCGGTTTCTGGCG	SubString{ASCIIString}["GTAAAGCGGTTTCTGGCGC"]
GGAGTGTCCACCTATGACC	SubString{ASCIIString}["GAGTGTCCACCTATGACCT"]
TTTATATGAGCACGGAAAG	SubString{ASCIIString}["TTATATGAGCACGGAAAGT"]
CAGTGTGAGGCTTATCAAC	SubString{ASCIIString}["AGTGTGAGGCTTATCAACG"]
TGAATGTTCCTACTCGCCC	SubString{ASCIIString}["GAATGTTCCTACTCGCCCT"]
GTAGGAGGAGAAGTAACCG	SubString{ASCIIString}["TAGGAGGAGAAGTAACCGC"]
GAGGAGAAGTAACCGCTTG	SubString{ASCIIString}["AGGAGAAGTAACCGCTTGC"]
AGGCCTCGAAAAACCAATC	SubString{ASCIIString}["GGCCTCGAAAAACCAATCT"]
AGACGCTTGAAAAGATGCA	SubString{ASCIIString}["GACGCTTGAAAAGATGCAG"]
CGTACTGCGAATGTTTTCA	SubString{ASCIIString}["GTACTGCGAATGTTTTCAA"]
TCACGGTAGCGCGAATTGA	SubString{ASCIIString}["CACGGTAGCGCGAATTGAG"]
TCTTAGATAATCGCGCGCA	SubString{ASCIIString}["CTTAGATAATCGCGCGCAA"]
CGGGCAGCCAACTAGTTCT	SubString{ASCIIString}["GGGCAGCCAACTAGTTCTG"]
CGGCAATGCAGCACCAGCC	SubString{ASCIIString}["GGCAATGCAGCACCAGCCA"]
GCGCTTTCAAAGCCTTGTC	SubString{ASCIIString}["CGCTTTCAAAGCCTTGTCC"]
GGATGTCCGAAAATCGCCA	SubString{ASCIIString}["GATGTCCGAAAATCGCCAA"]
ATCGGTTGAAGACATTTTC	SubString{ASCIIString}["TCGGTTGAAGACATTTTCC"]
GGTTGCGTTCGACAGTTAG	SubString{ASCIIString}["GTTGCGTTCGACAGTTAGC"]
TAAACAGTGTGCATACAGC	SubString{ASCIIString}["AAACAGTGTGCATACAGCC"]
TGTGCATACAGCCCTAATA	SubString{ASCIIString}["GTGCATACAGCCCTAATAG"]
TCCACAGATGGCTGAATGT	SubString{ASCIIString}["CCACAGATGGCTGAATGTT"]
AGCACCTCGCGCGGTTCTA	SubString{ASCIIString}["GCACCTCGCGCGGTTCTAC"]
CAAAGCCTTGTCCATCTAA	SubString{ASCIIString}["AAAGCCTTGTCCATCTAAA"]
GGGCAACTTGTTATAGTCC	SubString{ASCIIString}["GGCAACTTGTTATAGTCCT"]
TCGCGGGCATGTAGGAGGA	SubString{ASCIIString}["CGCGGGCATGTAGGAGGAG"]
CTTGTTATAGTCCTTTAGT	SubString{ASCIIString}["TTGTTATAGTCCTTTAGTC"]
TTTGCCGCATGGGGACATA	SubString{ASCIIString}["TTGCCGCATGGGGACATAT"]
GCTGAATGTTCCTACTCGC	SubString{ASCIIString}["CTGAATGTTCCTACTCGCC"]
TCACCCCGTGTTGCTGCGG	SubString{ASCIIString}["CACCCCGTGTTGCTGCGGG"]
GACTCCTGCCTTCATCTTT	SubString{ASCIIString}["ACTCCTGCCTTCATCTTTA"]
ACCCATCTAGCAGTGTTTA	SubString{ASCIIString}["CCCATCTAGCAGTGTTTAG"]
AGTTCATGGTACCTTAGTC	SubString{ASCIIString}["GTTCATGGTACCTTAGTCC"]
TTCGGCCGATTAAGTAAGT	SubString{ASCIIString}["TCGGCCGATTAAGTAAGTT"]
CGCGAATTGAGGCCGAACC	SubString{ASCIIString}["GCGAATTGAGGCCGAACCC"]
TCAAGCACCCATCTAGCAG	SubString{ASCIIString}["CAAGCACCCATCTAGCAGT"]
GGCAAAAAGCCATGTAGGA	SubString{ASCIIString}["GCAAAAAGCCATGTAGGAG"]
AGATTTTCCCTGTTCGGCC	SubString{ASCIIString}["GATTTTCCCTGTTCGGCCG"]
ATCCGAGGATCTGGTGGCT	SubString{ASCIIString}["TCCGAGGATCTGGTGGCTA"]
TGGAACTTATTTTGGCCAA	SubString{ASCIIString}["GGAACTTATTTTGGCCAAT"]
CCCTGTTCGGCCGATTAAG	SubString{ASCIIString}["CCTGTTCGGCCGATTAAGT"]
ATACATTCAGTGTGAGGCT	SubString{ASCIIString}["TACATTCAGTGTGAGGCTT"]
TCGGCAATGCAGCACCAGC	SubString{ASCIIString}["CGGCAATGCAGCACCAGCC"]
GGGGCTCAGGCGTGATCTG	SubString{ASCIIString}["GGGCTCAGGCGTGATCTGA"]
GACTTATCATAGAGGCTTA	SubString{ASCIIString}["ACTTATCATAGAGGCTTAT"]
AGGAGGAGAAGTAACCGCT	SubString{ASCIIString}["GGAGGAGAAGTAACCGCTT"]
TACAGCCGATATACGGGTC	SubString{ASCIIString}["ACAGCCGATATACGGGTCT"]
CAGTGGAGTACAAAAATGT	SubString{ASCIIString}["AGTGGAGTACAAAAATGTT"]
ACTTTCACACCGTGTTTTG	SubString{ASCIIString}["CTTTCACACCGTGTTTTGA"]
GCAGCACCAGCCAGTTCTC	SubString{ASCIIString}["CAGCACCAGCCAGTTCTCC"]
TATACGTCCGAAAATCGCC	SubString{ASCIIString}["ATACGTCCGAAAATCGCCA"]
CCTAGGCACCCACGGCATG	SubString{ASCIIString}["CTAGGCACCCACGGCATGC"]
TCACATGGTCATTTAGACA	SubString{ASCIIString}["CACATGGTCATTTAGACAG"]
TTGGACCCTATCCGTGGGC	SubString{ASCIIString}["TGGACCCTATCCGTGGGCA"]
CCCACATCTAGGGACTCAT	SubString{ASCIIString}["CCACATCTAGGGACTCATT"]
GTGTTTAGGCCTCGAAAAA	SubString{ASCIIString}["TGTTTAGGCCTCGAAAAAC"]
AGACCGCCAGTTAGTTTCG	SubString{ASCIIString}["GACCGCCAGTTAGTTTCGC"]
GCACAGTAGTCCTCCATAA	SubString{ASCIIString}["CACAGTAGTCCTCCATAAT"]
CTTTTGGCGGACTCCTGCC	SubString{ASCIIString}["TTTTGGCGGACTCCTGCCT"]
TCAATTGATCCTCTTTTAA	SubString{ASCIIString}["CAATTGATCCTCTTTTAAT"]
CGAACGACGCGGGCTTGCG	SubString{ASCIIString}["GAACGACGCGGGCTTGCGC"]
GATTCGGGCGACACCACAA	SubString{ASCIIString}["ATTCGGGCGACACCACAAC"]
TAAGTAAGTTTAAGGTAAT	SubString{ASCIIString}["AAGTAAGTTTAAGGTAATC"]
GTGTATGCTGCCACACAGC	SubString{ASCIIString}["TGTATGCTGCCACACAGCC"]
CACTGTGGTTGCAAAATCT	SubString{ASCIIString}["ACTGTGGTTGCAAAATCTC"]
AACAAGAGAAACACGCTGA	SubString{ASCIIString}["ACAAGAGAAACACGCTGAG"]
GGCGACACCACAACAAGAG	SubString{ASCIIString}["GCGACACCACAACAAGAGA"]
ACACCGTGTTTTGATTATA	SubString{ASCIIString}["CACCGTGTTTTGATTATAT"]
CAACTTGTTATAGTCCTTT	SubString{ASCIIString}["AACTTGTTATAGTCCTTTA"]
GGCATGCCCTTTTGGCGGA	SubString{ASCIIString}["GCATGCCCTTTTGGCGGAC"]
TAGCCGCTCTATCGGCTCT	SubString{ASCIIString}["AGCCGCTCTATCGGCTCTT"]
TCTTTCCGGAAGGCAGTTC	SubString{ASCIIString}["CTTTCCGGAAGGCAGTTCA"]
AGAAGTAACCGCTTGCGAC	SubString{ASCIIString}["GAAGTAACCGCTTGCGACA"]
GTCAACTGGGAAGTCGTGC	SubString{ASCIIString}["TCAACTGGGAAGTCGTGCA"]
TACGTGTCAGCAATAGTCT	SubString{ASCIIString}["ACGTGTCAGCAATAGTCTA"]
ATGCCCTTTTGGCGGACTC	SubString{ASCIIString}["TGCCCTTTTGGCGGACTCC"]
TCTTATCTGCTTTCACCAC	SubString{ASCIIString}["CTTATCTGCTTTCACCACA"]
TCGTGTTTTGGGGCTCAGG	SubString{ASCIIString}["CGTGTTTTGGGGCTCAGGC"]
ACAGGGGCAGTCATACTGG	SubString{ASCIIString}["CAGGGGCAGTCATACTGGA"]
AAGAAGAGAATACTTTGAT	SubString{ASCIIString}["AGAAGAGAATACTTTGATT"]
ATGTTACCAGATCCGAGGA	SubString{ASCIIString}["TGTTACCAGATCCGAGGAT"]
CGGTACAGGTTAATGTGCG	SubString{ASCIIString}["GGTACAGGTTAATGTGCGT"]
ACGTGTCAGCAATAGTCTA	SubString{ASCIIString}["CGTGTCAGCAATAGTCTAA"]
CGTAGCCGCTCTATCGGCT	SubString{ASCIIString}["GTAGCCGCTCTATCGGCTC"]
CGGTTGAAGACATTTTCCC	SubString{ASCIIString}["GGTTGAAGACATTTTCCCC"]
CACAGATGGCTGAATGTTC	SubString{ASCIIString}["ACAGATGGCTGAATGTTCC"]
ATATAGTCCGGAAGATTTT	SubString{ASCIIString}["TATAGTCCGGAAGATTTTC"]
GCAGCGATACTTTCACACC	SubString{ASCIIString}["CAGCGATACTTTCACACCG"]
CCGACCCCAGCTCGCGCCC	SubString{ASCIIString}["CGACCCCAGCTCGCGCCCA"]
CACCTCGCGCGGTTCTACG	SubString{ASCIIString}["ACCTCGCGCGGTTCTACGT"]
GGGTCTGCATAGTTGAATC	SubString{ASCIIString}["GGTCTGCATAGTTGAATCC"]
GCGACAAGGTCCTAGGACC	SubString{ASCIIString}["CGACAAGGTCCTAGGACCG"]
GAGAGCTGACAGCGCGTGG	SubString{ASCIIString}["AGAGCTGACAGCGCGTGGG"]
CCCTATCCGTGGGCAACTT	SubString{ASCIIString}["CCTATCCGTGGGCAACTTG"]
ACATCTAGGGACTCATTCA	SubString{ASCIIString}["CATCTAGGGACTCATTCAA"]
CCTTCCAGACAGACGCTTG	SubString{ASCIIString}["CTTCCAGACAGACGCTTGA"]
ACTAGTTCTGACCTAATAT	SubString{ASCIIString}["CTAGTTCTGACCTAATATA"]
AATTGTTCGCGGGCATGTA	SubString{ASCIIString}["ATTGTTCGCGGGCATGTAG"]
GGTACCTTAGTCCGAAAAT	SubString{ASCIIString}["GTACCTTAGTCCGAAAATC"]
GTTATAGTCCTTTAGTCTT	SubString{ASCIIString}["TTATAGTCCTTTAGTCTTT"]
TCTTCGGTATTCCGGCATT	SubString{ASCIIString}["CTTCGGTATTCCGGCATTC"]
CATCTTATCTGCTTTCACC	SubString{ASCIIString}["ATCTTATCTGCTTTCACCA"]
GGCCCCTAGACTCCGAGCA	SubString{ASCIIString}["GCCCCTAGACTCCGAGCAG"]
ACAAGAAATGATCACCCCG	SubString{ASCIIString}["CAAGAAATGATCACCCCGT"]
TCGAGTCGCCGGTAAACTC	SubString{ASCIIString}["CGAGTCGCCGGTAAACTCC"]
CCGTAGCCGCTCTATCGGC	SubString{ASCIIString}["CGTAGCCGCTCTATCGGCT"]
AAGCAACATTATCAAATCC	SubString{ASCIIString}["AGCAACATTATCAAATCCG"]
CCATGCCGACCCCAGCTCG	SubString{ASCIIString}["CATGCCGACCCCAGCTCGC"]
CACCCACGGCATGCCCTTT	SubString{ASCIIString}["ACCCACGGCATGCCCTTTT"]
TGTCTAGTTTTCGCAGCTG	SubString{ASCIIString}["GTCTAGTTTTCGCAGCTGG"]
ACCACAACAAGAGAAACAC	SubString{ASCIIString}["CCACAACAAGAGAAACACG"]
AGATTTACTAAAGCTAGCC	SubString{ASCIIString}["GATTTACTAAAGCTAGCCA"]
ACCTAGGCACCCACGGCAT	SubString{ASCIIString}["CCTAGGCACCCACGGCATG"]
CGAACCCACTAGTCCGGAC	SubString{ASCIIString}["GAACCCACTAGTCCGGACC"]
ACTTGAGACCGCCAGTTAG	SubString{ASCIIString}["CTTGAGACCGCCAGTTAGT"]
CACAATGATTCGGGCGACA	SubString{ASCIIString}["ACAATGATTCGGGCGACAC"]
AGCCAGTTCTCCTTACTTG	SubString{ASCIIString}["GCCAGTTCTCCTTACTTGA"]
ACTAAAGCTAGCCATGAGA	SubString{ASCIIString}["CTAAAGCTAGCCATGAGAG"]
ATTGATCCTCTTTTAATAA	SubString{ASCIIString}["TTGATCCTCTTTTAATAAT"]
GTTCCGTAGCCGCTCTATC	SubString{ASCIIString}["TTCCGTAGCCGCTCTATCG"]
GTGGCTAGTAAAGCGGTTT	SubString{ASCIIString}["TGGCTAGTAAAGCGGTTTC"]
CGGAGACATGTTACCAGAT	SubString{ASCIIString}["GGAGACATGTTACCAGATC"]
CTTTAAACAGTGTGCATAC	SubString{ASCIIString}["TTTAAACAGTGTGCATACA"]
ATCTAACCGCCCCTGGCGA	SubString{ASCIIString}["TCTAACCGCCCCTGGCGAA"]
TTTTGATTATATCGGTTGA	SubString{ASCIIString}["TTTGATTATATCGGTTGAA"]
TTTTGGTGACTTAACAAGA	SubString{ASCIIString}["TTTGGTGACTTAACAAGAA"]
TTCTGACCTAATATAGTCC	SubString{ASCIIString}["TCTGACCTAATATAGTCCG"]
CGGCTCTTCATGACCTGGG	SubString{ASCIIString}["GGCTCTTCATGACCTGGGT"]
CGCGCAAGTTTGCATTCCA	SubString{ASCIIString}["GCGCAAGTTTGCATTCCAC"]
ATGATTCGGGCGACACCAC	SubString{ASCIIString}["TGATTCGGGCGACACCACA"]
CTGGCTAGCGTGAAAAATT	SubString{ASCIIString}["TGGCTAGCGTGAAAAATTC"]
GTGGTCGTGTTTTGGGGCT	SubString{ASCIIString}["TGGTCGTGTTTTGGGGCTC"]
CTGAATGGATGTCCGAAAA	SubString{ASCIIString}["TGAATGGATGTCCGAAAAT"]
CGGGTCTGCATAGTTGAAT	SubString{ASCIIString}["GGGTCTGCATAGTTGAATC"]
ATGCAGTAGGCGGAGTTCT	SubString{ASCIIString}["TGCAGTAGGCGGAGTTCTA"]
AAAATTCACGGTAGCGCGA	SubString{ASCIIString}["AAATTCACGGTAGCGCGAA"]
TTGAGGCCGAACCCACTAG	SubString{ASCIIString}["TGAGGCCGAACCCACTAGT"]
GGTATGTGGAACTTATTTT	SubString{ASCIIString}["GTATGTGGAACTTATTTTG"]
TATAGTCCGGAAGATTTTC	SubString{ASCIIString}["ATAGTCCGGAAGATTTTCC"]
ATCGGGAGGTGCTGGCTAG	SubString{ASCIIString}["TCGGGAGGTGCTGGCTAGC"]
TAGTCCGGAAGATTTTCCC	SubString{ASCIIString}["AGTCCGGAAGATTTTCCCT"]
AGACTCCGAGCAGCGATAC	SubString{ASCIIString}["GACTCCGAGCAGCGATACT"]
CCTCTTTTAATAATACAGA	SubString{ASCIIString}["CTCTTTTAATAATACAGAT"]
TGCGACAAGGTCCTAGGAC	SubString{ASCIIString}["GCGACAAGGTCCTAGGACC"]
TCGAAAAACCAATCTATAC	SubString{ASCIIString}["CGAAAAACCAATCTATACG"]
GGAAGTCGTGCACAGTAGT	SubString{ASCIIString}["GAAGTCGTGCACAGTAGTC"]
GGAGACATGTTACCAGATC	SubString{ASCIIString}["GAGACATGTTACCAGATCC"]
GGAGGAGAAGTAACCATGC	SubString{ASCIIString}["GAGGAGAAGTAACCATGCC"]
CAACCCCGGTTCGCTTGTG	SubString{ASCIIString}["AACCCCGGTTCGCTTGTGC"]
TCTCCCTGGCCCACCTGTT	SubString{ASCIIString}["CTCCCTGGCCCACCTGTTT"]
ATAGTCCGGAAGATTTTCC	SubString{ASCIIString}["TAGTCCGGAAGATTTTCCC"]
GTAGGAGGAGAAGTAACCA	SubString{ASCIIString}["TAGGAGGAGAAGTAACCAC","TAGGAGGAGAAGTAACCAT"]
GACGCGGGCTTGCGCATCA	SubString{ASCIIString}["ACGCGGGCTTGCGCATCAT"]
GTACCCTGCGCGGTCAACT	SubString{ASCIIString}["TACCCTGCGCGGTCAACTG"]
GCCCACATCTAGGGACTCA	SubString{ASCIIString}["CCCACATCTAGGGACTCAT"]
CTCCGAGCAGCGATACTTT	SubString{ASCIIString}["TCCGAGCAGCGATACTTTC"]
ATGACCTTCCAGACAGACG	SubString{ASCIIString}["TGACCTTCCAGACAGACGC"]
TGCCTTCATCTTTAAACAG	SubString{ASCIIString}["GCCTTCATCTTTAAACAGT"]
GTGACTTAACAAGAAATGA	SubString{ASCIIString}["TGACTTAACAAGAAATGAT"]
GAACGGCCCCTAGACTCCG	SubString{ASCIIString}["AACGGCCCCTAGACTCCGA"]
GAAAAGTTCATGGTACCTT	SubString{ASCIIString}["AAAAGTTCATGGTACCTTA"]
AGCGGTTTCTGGCGCGCGG	SubString{ASCIIString}["GCGGTTTCTGGCGCGCGGT"]
GATTTTCCCTGTTCGGCCG	SubString{ASCIIString}["ATTTTCCCTGTTCGGCCGA"]
CAGTGCGTAGGGGGTATGT	SubString{ASCIIString}["AGTGCGTAGGGGGTATGTG"]
TAACATCTTATCTGCTTTC	SubString{ASCIIString}["AACATCTTATCTGCTTTCA"]
TGCACAGTAGTCCTCCATA	SubString{ASCIIString}["GCACAGTAGTCCTCCATAA"]
AAAGCCATGTAGGAGGAGA	SubString{ASCIIString}["AAGCCATGTAGGAGGAGAA"]
GGACATGGCACCTTTATTA	SubString{ASCIIString}["GACATGGCACCTTTATTAT"]
CCACCCACAATGATTCGGG	SubString{ASCIIString}["CACCCACAATGATTCGGGC"]
GACATATCTAACCGCCCCT	SubString{ASCIIString}["ACATATCTAACCGCCCCTG"]
TGTTTGAAAAGTTCATGGT	SubString{ASCIIString}["GTTTGAAAAGTTCATGGTA"]
TTTTCAATTGATCCTCTTT	SubString{ASCIIString}["TTTCAATTGATCCTCTTTT"]
TACGGCATTGTCTAGTTTT	SubString{ASCIIString}["ACGGCATTGTCTAGTTTTC"]
CGCCAGTTAGTTTCGCGCT	SubString{ASCIIString}["GCCAGTTAGTTTCGCGCTT"]
ATTCCGTGACTCGTGTCGC	SubString{ASCIIString}["TTCCGTGACTCGTGTCGCT"]
CCAAACCTGAATCGGGAGG	SubString{ASCIIString}["CAAACCTGAATCGGGAGGT"]
CCTGGCGAACCTAGGCACC	SubString{ASCIIString}["CTGGCGAACCTAGGCACCC"]
AGTGTGCATACAGCCCTAA	SubString{ASCIIString}["GTGTGCATACAGCCCTAAT"]
GAAACACGCTGAGCAAAAT	SubString{ASCIIString}["AAACACGCTGAGCAAAATA"]
GTGTCAGCAATAGTCTAAG	SubString{ASCIIString}["TGTCAGCAATAGTCTAAGC"]
CGAAAAACCAATCTATACG	SubString{ASCIIString}["GAAAAACCAATCTATACGT"]
GTCCACCTATGACCTTCCA	SubString{ASCIIString}["TCCACCTATGACCTTCCAG"]
AAAGCCTTGTCCATCTAAA	SubString{ASCIIString}["AAGCCTTGTCCATCTAAAT"]
ACAAGAGAAACACGCTGAG	SubString{ASCIIString}["CAAGAGAAACACGCTGAGC"]
TTATTTTGGGCCAGAACGG	SubString{ASCIIString}["TATTTTGGGCCAGAACGGC"]
ATTCCACAGATGGCTGAAT	SubString{ASCIIString}["TTCCACAGATGGCTGAATG"]
GGGCCTTATGAGTGTATGC	SubString{ASCIIString}["GGCCTTATGAGTGTATGCT"]
GACCTGGGTTGCGTTCGAC	SubString{ASCIIString}["ACCTGGGTTGCGTTCGACA"]
CGCGGGCATGTAGGAGGAG	SubString{ASCIIString}["GCGGGCATGTAGGAGGAGA"]
CCAAATGGCAAAAAGCCAT	SubString{ASCIIString}["CAAATGGCAAAAAGCCATG"]
GGACTCATTCAATTCTTAG	SubString{ASCIIString}["GACTCATTCAATTCTTAGA"]
AACGCCCATTTTCTTCGGT	SubString{ASCIIString}["ACGCCCATTTTCTTCGGTA"]
CTAGCAGTGTTTAGGCCTC	SubString{ASCIIString}["TAGCAGTGTTTAGGCCTCG"]
TCGCGCGCAAGTTTGCATT	SubString{ASCIIString}["CGCGCGCAAGTTTGCATTC"]
CGGACTCCTGCCTTCATCT	SubString{ASCIIString}["GGACTCCTGCCTTCATCTT"]
GAGAAGTAACCGCTTGCGA	SubString{ASCIIString}["AGAAGTAACCGCTTGCGAC"]
GGACCCTATCCGTGGGCAA	SubString{ASCIIString}["GACCCTATCCGTGGGCAAC"]
ACTCCTGCCTTCATCTTTA	SubString{ASCIIString}["CTCCTGCCTTCATCTTTAA"]
GCAATAGTCTAAGCGCTAC	SubString{ASCIIString}["CAATAGTCTAAGCGCTACC"]
CGGTAGCGCGAATTGAGGC	SubString{ASCIIString}["GGTAGCGCGAATTGAGGCC"]
AGTCTAAGCGCTACCGTCG	SubString{ASCIIString}["GTCTAAGCGCTACCGTCGT"]
GCTTATCAACGCCCATTTT	SubString{ASCIIString}["CTTATCAACGCCCATTTTC"]
AGGCAGTTCATCTCCCTGG	SubString{ASCIIString}["GGCAGTTCATCTCCCTGGC"]
ATTATCACATGTAGGAGGA	SubString{ASCIIString}["TTATCACATGTAGGAGGAG"]
AATCTATACGTCCGAAAAT	SubString{ASCIIString}["ATCTATACGTCCGAAAATC"]
CCTTAGTCCGAAAATCGCC	SubString{ASCIIString}["CTTAGTCCGAAAATCGCCA"]
CAACATTATCAAATCCGGG	SubString{ASCIIString}["AACATTATCAAATCCGGGC"]
TAGGCACCCACGGCATGCC	SubString{ASCIIString}["AGGCACCCACGGCATGCCC"]
CGCCCACATCTAGGGACTC	SubString{ASCIIString}["GCCCACATCTAGGGACTCA"]
GATCTGGTGGCTAGTAAAG	SubString{ASCIIString}["ATCTGGTGGCTAGTAAAGC"]
CGCCCTATATGCAGTGCGT	SubString{ASCIIString}["GCCCTATATGCAGTGCGTA"]
AATCGCCAAATACGATTAT	SubString{ASCIIString}["ATCGCCAAATACGATTATC"]
AAATTCACGGTAGCGCGAA	SubString{ASCIIString}["AATTCACGGTAGCGCGAAT"]
TCAAAGCCTTGTCCATCTA	SubString{ASCIIString}["CAAAGCCTTGTCCATCTAA"]
TCCTCCATAATCGGAGACA	SubString{ASCIIString}["CCTCCATAATCGGAGACAT"]
GGCGCTTTCAAAGCCTTGT	SubString{ASCIIString}["GCGCTTTCAAAGCCTTGTC"]
GCTTGAAAAGATGCAGTAG	SubString{ASCIIString}["CTTGAAAAGATGCAGTAGG"]
TAGATAATCGCGCGCAAGT	SubString{ASCIIString}["AGATAATCGCGCGCAAGTT"]
TCATGGGTTCATGACCAGG	SubString{ASCIIString}["CATGGGTTCATGACCAGGG"]
CGGTTCGCTTGTGCGTTCA	SubString{ASCIIString}["GGTTCGCTTGTGCGTTCAC"]
GCCCTTTTGGCGGACTCCT	SubString{ASCIIString}["CCCTTTTGGCGGACTCCTG"]
TTCCGTAGCCGCTCTATCG	SubString{ASCIIString}["TCCGTAGCCGCTCTATCGG"]
GATGGCTGAATGTTCCTAC	SubString{ASCIIString}["ATGGCTGAATGTTCCTACT"]
TGAAAAATTCACGGTAGCG	SubString{ASCIIString}["GAAAAATTCACGGTAGCGC"]
CCACAGATGGCTGAATGTT	SubString{ASCIIString}["CACAGATGGCTGAATGTTC"]
GACCTAATATAGTCCGGAA	SubString{ASCIIString}["ACCTAATATAGTCCGGAAG"]
